a/an	""	四
abandon	""	四
abbreviation	""	六
abide	""	六
able	"ability"	四
abnormal	""	六
aboard	""	四
abolish	"abolition"	四
abort	"abortion"	六
about	""	四
above	""	四
abreast	""	六
abroad	""	四
abrupt	""	六
absent	"absence"	四
absolute	""	四
absorb	"absorption"	四
abstract	""	四
absurd	"absurdity"	六
abundant	"abundance"	四
abuse	"abusive"	四
academy	"academic,academician"	四
accelerate	"acceleration"	四
accent	""	四
accept	"acceptance,acceptable"	四
access	"accessible"	四
accessory	""	六
accident	"accidental"	四
acclaim	""	六
accommodate	"accommodation"	四
accompany	""	四
accomplish	"accomplishment"	四
accord	""	四
accordance	""	四
according-to	""	四
accordingly	""	四
account	"accounting,accountant,accountancy"	四
accountable	"accountability"	四
accumulate	"accumulation,accumulative"	四
accurate	"accuracy"	四
accuse	"accusation"	四
accustom	"accustomed"	四
ace	""	四
ache	""	四
achieve	"achievement"	四
acid	"acidity"	四
acknowledge	"acknowledg(e)ment"	四
acquaint	"acquaintance"	四
acquire	"acquisition"	四
acre	""	四
across	""	四
act	"action,acting"	四
activate	""	六
active	"activity,activist"	四
actor	"actress"	四
actual	"actually"	四
acupuncture	""	六
acute	""	四
adapt	"adaptation,adaptive"	四
add	"addition,additional"	四
addict	"addiction,addictive"	四
address	""	四
adequate	"adequacy,adequately"	四
adhere	"adherence"	六
adjacent	""	六
adjective	""	四
adjust	"adjustment"	四
administer/administrate	"administration,administrative"	四
admire	"admiration,admirable"	四
admit	"admission,admittance,admittedly"	四
adolescent	"adolescence"	六
adopt	"adoption"	四
adore	"adorable"	六
adult	"adulthood"	四
advance	"advancement,advanced"	四
advantage	"advantageous"	四
advent	""	六
adventure	"adventurer,adventurous"	四
adverb	""	四
adversary	""	六
adverse	"adversity"	六
advertise	"advertisement/ad,advertising"	四
advice	""	四
advise	"advisor/-er,advisory,advisable"	四
advocate	"advocacy"	四
aerial	""	四
aesthetic	"aesthetics"	六
affair	""	四
affect	""	四
affection	"affectionate"	四
affiliate	"affiliation"	六
affirm	"affirmation,affirmative"	六
affix	"affixation"	六
affluent	"affluence"	四
afford	"affordable,affordability"	四
afloat	""	六
afraid	""	四
after	""	四
aftermath	""	六
afternoon	""	四
afterward(s)	""	四
again	""	四
against	""	四
age	"aged,ag(e)ing"	四
agenda	""	四
agent	"agency"	四
aggravate	"aggravation"	六
aggregate	""	六
aggressive	"aggression"	四
agitate	"agitation"	六
ago	""	四
agony	""	六
agree	"agreement,agreeable"	四
agriculture	"agricultural"	四
ahead	""	四
aid	""	四
aide	""	六
AIDS	""	四
ail	"ailment"	六
aim	""	四
air	""	四
airborne	""	六
air-conditioning	"air-conditioner"	四
aircraft	""	四
airline	""	四
airplane/aeroplane	""	四
airport	""	四
aisle	""	四
akin	""	六
alarm	""	四
album	""	四
alcohol	"alcoholic"	四
ale	""	六
alert	""	四
algebra	""	四
alien	"alienate,alienation"	六
align	"alignment"	六
alike	""	四
alive	""	四
all	""	四
allege	"allegation,alleged,allegedly"	四
allergic	"allergy"	六
alleviate	"alleviation"	六
alley	""	四
allocate	"allocation"	六
allot	"allotment"	六
allow	""	四
allowance	""	四
alloy	""	六
allude	"allusion"	六
allure	"allurement"	六
ally	"alliance"	四
almighty	""	六
almost	""	四
aloft	""	六
alone	""	四
along	""	四
alongside	""	四
aloud	""	四
alphabet	"alphabetic(al)"	四
already	""	四
also	""	四
alter	"alteration"	四
alternate	"alternation,alternately"	六
alternative	""	四
although	""	四
altitude	""	四
altogether	""	四
alumin(i)um	""	四
always	""	四
am	""	四
amass	""	六
amateur	""	四
amaze	"amazing,amazement"	四
ambassador	""	四
ambiguous	"ambiguity"	六
ambition	"ambitious"	四
ambulance	""	四
amend	"amendment"	六
amiable	""	六
amid(st)	""	四
ammunition	""	六
among(st)	""	四
amount	""	四
ample	""	四
amplify	"amplification"	六
amuse	"amusing,amusement"	四
analog(ue)	"analogous"	六
analogy	""	六
analyze/-yse	"analysis,analytic(al),analyst"	四
ancestor	"ancestry"	四
anchor	"anchorage"	四
ancient	""	四
and	""	四
anecdote	"anecdotal"	六
anew	""	四
angel	""	四
angle	""	四
angry	"anger"	四
anguish	""	六
animal	""	四
animate	"animated,animation"	六
ankle	""	四
annex	"annexation"	六
anniversary	""	四
announce	"announcement"	四
annoy	"annoyance"	四
annual	""	四
anonymous	"anonymity"	六
another	""	四
answer	""	四
ant	""	四
antagonism	"antagonist,antagonistic,antagonistically"	六
antenna	""	六
antibiotic	""	六
anticipate	"anticipation"	四
antique	""	四
antonym	""	六
anxious	"anxiety"	四
any	""	四
anybody/=anyone	""	四
anyway/=anyhow	""	四
anything	""	四
anywhere	""	四
apart	""	四
apartment/apt．	""	四
ape	""	六
apology	"apologize/-ise,apologetic"	四
app	""	四
appal(l)	"appalling"	六
apparatus	""	四
apparent	"apparently"	四
appeal	"appealing"	四
appear	"appearance"	四
appease	"appeasement"	六
appendix	""	六
appetite	""	四
applaud	"applause"	四
apple	""	四
appliance	""	四
apply	"application,applicant,applicable"	四
appoint	"appointment"	四
appraise	"appraisal"	六
appreciate	"appreciation,appreciative"	四
apprentice	""	六
approach	""	四
appropriate1	""	四
appropriate2	"appropriation"	六
approve	"approval"	四
approximate	"approximately,approximation"	四
April	""	四
apron	""	六
apt	"aptly"	六
aptitude	""	四
arbitrary	"arbitrarily"	四
arbitrate	"arbitration"	六
arc	""	六
arch	""	六
architect	""	四
architecture	""	四
archive	""	六
ardent	""	六
area	""	四
arena	""	六
argue	"argument,argumentation,argumentative,arguable"	四
arise	""	四
aristocrat	"aristocratic,aristocracy"	六
arithmetic	""	四
arm	"armament"	四
armo(u)r	""	六
army	""	四
around	""	四
arouse	"arousal"	四
arrange	"arrangement"	四
array	""	六
arrest	""	四
arrive	"arrival"	四
arrogant	"arrogance"	六
arrow	""	四
art	"artist,artistic,artistically"	四
artery	""	六
article	""	四
articulate	"articulation"	六
artifact	""	六
artificial	""	四
artillery	""	六
as	""	四
ascend	"ascendance"	六
ascertain	""	六
ascribe	""	六
ash	""	四
ashamed	""	四
ashore	""	四
aside	""	四
ask	""	四
asleep	""	四
aspect	""	四
aspire	"aspiration"	六
ass	""	四
assassinate	"assassination,assassin"	六
assault	""	六
assemble	"assembly"	四
assert	"assertion,assertive"	六
assess	"assessment"	四
asset	""	四
assign	"assignment"	四
assimilate	"assimilation"	六
assist	"assistance,assistant"	四
associate	"association"	四
assorted	""	六
assortment	""	六
assume	"assumption"	四
assure	"assurance"	四
astonish	"astonishment"	四
astray	""	六
astronaut	""	四
astronomy	"astronomer,astronomical"	四
asylum	""	六
at	""	四
athlete	"athletic"	四
atlas	""	六
atmosphere	"atmospheric"	四
atom	"atomic"	四
atop	""	四
atrocity	"atrocious"	六
attach	"attachment"	四
attack	""	四
attain	"attainment"	四
attempt	""	四
attend	"attendance,attendant"	四
attention	"attentive"	四
attic	""	四
attitude	""	四
attorney	""	四
attract	"attraction,attractive"	四
attribute	"attributable,attributive"	四
auction	"auctioneer"	六
audience	""	四
audio	""	四
audit	"auditing,auditor"	六
auditorium	""	四
augment	"augmentation"	六
August	""	四
aunt	"auntie"	四
authentic	"authenticity"	四
author	""	四
authority	"authoritative"	四
authorize/-ise	"authorization/-sation"	四
auto(mobile)	""	四
autobiography	"autobiographic(al)"	六
automate	"automation,automatic,automatically"	四
autonomous	"autonomy"	六
autumn	""	四
auxiliary	""	六
avail	""	六
available	"availability"	四
avenge	""	六
avenue	""	四
average	""	四
avert	"aversion"	六
aviation	""	四
avoid	"avoidance"	四
await	""	四
awake	""	四
award	""	四
aware	"awareness"	四
away	""	四
awe	""	四
awesome	""	四
awful	""	四
awkward	""	四
ax(e)	""	四
axis	""	四
baby	""	四
baby-boom	"baby-boomer"	四
bachelor	""	四
back	""	四
background	""	四
backup	""	四
backward	"backwards"	四
backyard	""	四
bacon	""	四
bacteria	""	四
bad	""	四
badge	""	四
badly	""	四
badminton	""	四
baffle	""	六
bag	""	四
baggage	""	四
bail	""	四
bait	""	四
bake	"bakery"	四
balance	""	四
balcony	""	四
bald	""	六
ball	""	四
ballet	""	四
balloon	""	四
ballot	""	四
bamboo	""	四
ban	""	四
banana	""	四
band	""	四
bandage	""	四
bang	""	四
bank1	"banking,banker"	四
bank2	""	四
banknote	""	四
bankrupt	"bankruptcy"	四
banner	""	四
banquet	""	四
bar	""	四
barbecue/BBQ	""	四
barber	""	四
bare	"barely"	四
bargain	""	四
barge	""	六
bark	""	四
barn	""	六
barometer	""	六
barracks	""	六
barrel	""	四
barren	""	六
barrier	""	四
base	""	四
baseball	""	四
basement	""	四
basic	"basically"	四
basin	""	四
basis	""	四
basket	""	四
basketball	""	四
bass	""	六
bat	""	四
batch	""	四
bath	""	四
bathe	""	四
bathroom	""	四
battalion	""	四
batter	""	六
battery	""	四
battle	""	四
bay	""	四
be	""	四
beach	""	四
bead	""	六
beak	""	六
beam	""	四
bean	""	四
bear	""	四
beard	""	四
bearing	""	四
beast	""	四
beat	""	四
beauty	"beautiful,beautify"	四
because	""	四
beckon	""	六
become	""	四
bed	"bedding"	四
bee	""	四
beef	""	四
beer	""	四
beetle	""	六
before	""	四
beforehand	""	四
beg	"beggar"	四
begin	"beginning"	四
behalf	""	四
behave	"behavio(u)r,behavio(u)ral"	四
behind	""	四
being	""	四
belief	""	四
believe	""	四
bell	""	四
bely	""	四
belong	"belongings"	四
beloved	""	四
below	""	四
belt	""	四
bench	""	四
bend	""	四
beneath	""	四
benefit	"beneficial,beneficiary"	四
benevolent	"benevolence"	六
benign	""	六
berry	""	四
beset	""	六
beside	""	四
besides	""	四
besiege	""	六
best	""	四
best-seller	"best-selling"	四
bet	""	四
betray	"betrayal"	四
better	""	四
between	""	四
beverage	""	四
beware	""	六
bewilder	"bewilderment"	六
beyond	""	四
bias	""	四
Bible	"Biblical/biblical"	四
bibliography	""	六
bicycle/bike	""	四
bid	""	四
big	""	四
bilateral	""	六
bill	""	四
billion	"billionaire"	四
bin	""	四
bind	""	四
binoculars	""	六
biochemistry	"biochemical,biochemist"	四
biography	"biographical,biographer"	四
biology	"biological,biologist"	四
biotechnology	""	四
bird	""	四
birth	""	四
birthday	""	四
biscuit	""	四
bishop	""	六
bit	""	四
bitch	""	四
bite	""	四
bitter	""	四
bizarre	""	六
black	""	四
blackboard	""	四
blackmail	""	六
blade	""	四
blame	""	四
blank	""	四
blanket	""	四
blast	""	四
blaze	""	六
bleach	""	六
bleak	""	六
bleed	""	四
blend	""	四
bless	"blessing"	四
blind	""	四
blink	""	六
bloc	""	六
block	""	四
blog	""	四
blond(e)	""	四
blood	"bloody"	四
bloom	""	四
blossom	""	四
blouse	""	四
blow	""	四
blue	""	四
blueprint	""	四
bluff	""	六
blunder	""	六
blunt	""	六
blur	""	四
blush	""	六
board	""	四
boast	"boastful"	四
boat	""	四
body	"bodily"	四
boil	"boiler"	四
bold	""	四
bolster	""	六
bolt	""	四
bomb	""	四
bond	"bondage"	四
bone	"bony"	四
bonus	""	四
book	""	四
boom	""	四
boost	""	四
boot	""	四
booth	""	四
border	""	四
bore1	"boring"	四
bore2	""	四
born	""	四
borrow	""	四
boss	""	四
botany	"botanical"	六
both	""	四
bother	""	四
bottle	""	四
bottom	""	四
bounce	""	四
bound1	""	四
bound2	""	四
bound3	""	四
boundary	""	四
bouquet	""	六
bout	""	六
bow1	""	四
bow2	""	四
bowel	""	四
bowl	""	四
box1	""	四
box2	""	四
boxing	""	四
boy	""	四
boycott	""	六
brace	""	六
bracket	""	四
brag	""	四
brain	""	四
brake	""	四
branch	""	四
brand	""	四
brand-new	""	四
brandy	""	四
brass	""	四
brave	"bravery"	四
breach	""	六
bread	""	四
break	""	四
breakdown	""	四
breakfast	""	四
breakthrough	""	四
breast	""	四
breath	""	四
breathe	""	四
breed	""	四
breeze	""	四
brew	"brewery"	六
bribe	"bribery"	四
brick	""	四
bride	""	四
bridegroom	""	四
bridge	""	四
brief	"briefing"	四
briefcase	""	四
brigade	""	六
bright	"brighten"	四
brilliant	"brilliance"	四
bring	""	四
brink	""	六
brisk	""	六
broad	"broaden,breadth"	四
broadcast	""	四
brochure	""	四
broke	""	四
broker	""	四
bronze	""	六
brood	""	六
broom	""	四
brother	""	四
brow	""	四
brown	""	四
browse	"browser"	四
bruise	""	六
brunch	""	四
brush	""	四
brutal	"brutality"	四
bubble	""	四
buck	""	四
bucket	""	四
buckle	""	四
bud	""	四
buddy	""	四
Buddhism	"Buddhist"	六
budget	"budgetary"	四
buffalo	""	六
buffer	""	六
buffet	""	四
bug	""	四
build	"building"	四
bulb	""	四
bulk	"bulky"	四
bull	""	四
bullet	""	四
bulletin	""	四
bully	""	四
bump	""	四
bumper	""	四
bunch	""	四
bundle	""	四
burden	""	四
bureau	""	四
bureaucrat	"bureaucratic,bureaucracy"	六
burglar	"burglary"	六
burn	""	四
burst	""	四
bury	"burial"	四
bus	""	四
bush	"bushy"	四
business	""	四
businessman	""	四
bust	""	六
busy	""	四
but	""	四
butcher	""	四
butt	""	六
butter	""	四
butterfly	""	四
button	""	四
buy	"buyer"	四
buzz	""	六
by	""	四
bypass	""	四
bystander	""	四
cab	""	四
cabbage	""	四
cabin	""	四
cabinet	""	四
cable	""	四
cafe	""	四
cafeteria	""	四
cage	""	四
cake	""	四
calcium	""	六
calculate	"calculation,calculator,calculating"	四
calendar	""	四
calf	""	四
call	""	四
calling	""	四
calm	""	四
calorie	""	四
camel	""	四
camera	""	四
camp	""	四
campaign	""	四
campus	""	四
can1	""	四
can2	""	四
canal	""	四
cancel	"cancelation"	四
cancer	""	四
candidate	"candidacy"	四
candle	""	四
candy	""	四
cane	""	四
cannon	""	六
canoe	""	六
canteen	""	四
canvas	""	六
cap	""	四
capable	"capability"	四
capacity	""	四
cape	""	六
capital	"capitalist,capitalism"	四
capsule	""	六
captain	""	四
caption	""	六
captive	""	六
capture	""	四
car	""	四
caravan	""	六
carbohydrate	""	六
carbon	""	四
card	""	四
cardboard	""	四
cardinal	""	六
care	"careful,careless"	四
career	""	四
cargo	""	四
carpenter	""	四
carpet	""	四
carriage	""	四
carrier	""	四
carrot	""	四
carry	""	四
cart	""	四
carton	""	六
cartoon	"cartoonist"	四
carve	"carving"	六
case	""	四
cash	""	四
cashier	""	四
casino	""	六
cast	""	四
castle	""	四
casual	""	四
casualty	""	六
cat	""	四
catalog(ue)	""	四
catastrophe	"catastrophic"	六
catch	""	四
category	""	四
cater	""	四
cathedral	""	六
Catholic	""	六
cattle	""	四
cauliflower	""	六
cause	""	四
caution	"cautious"	四
cave	""	四
cavity	""	六
cease	""	四
ceiling	""	四
celebrate	"celebration"	四
celebrity	""	六
cell	""	四
cellar	""	四
cell-phone	""	四
Celsius/-cius	""	四
cement	""	四
cemetery	""	六
censor	"censorship"	六
census	""	六
cent	""	四
center/-tre	"central,centralize/-ise"	四
centigrade	""	四
centimeter/-tre	""	四
century	""	四
ceramic	""	六
cereal	""	四
ceremony	"ceremonial"	四
certain	"certainly,certainty"	四
certificate	""	四
certify	"certification"	六
chain	""	四
chair	""	四
chairman/chairperson	""	四
chalk	""	四
challenge	"challenging"	四
chamber	""	六
champagne	""	四
champion	"championship"	四
chance	""	四
chancellor	""	六
change	""	四
channel	""	四
chant	""	六
chaos	"chaotic"	四
chapel	""	六
chapter	""	四
character	"characteristic,characterize/-ise"	四
charge	""	四
charity	"charitable"	四
charm	"charming"	四
chart	""	四
charter	""	四
chase	""	四
chat	""	四
cheap	""	四
cheat	""	四
check1	""	四
check2/cheque	""	四
cheek	""	四
cheer	"cheerful"	四
cheese	""	四
chef	""	四
chemistry	"chemical,chemist"	四
cherish	""	四
chess	""	四
chest	""	四
chew	""	四
chicken	""	四
chief	""	四
child	"childish"	四
chill	"chilly"	四
chimney	""	四
chin	""	四
china	""	四
chip	""	四
chocolate	""	四
choice	""	四
choir	""	六
choke	""	四
cholesterol	""	四
choose	"choosy"	四
chop	""	四
chopstick	""	四
chord	""	六
chore	""	四
chorus	""	四
Christ	"Christmas,Christian,Christianity"	四
chronic	"chronically"	六
chronicle	""	六
chunk	""	六
church	""	四
cigar	""	四
cigaret(te)	""	四
cinema	""	四
circle	"circular"	四
circuit	""	四
circulate	"circulation"	四
circumstance	""	四
circus	""	四
cite	"citation"	四
citizen	"citizenship"	四
city	""	四
civic	""	六
civil	"civilize/-ise,civilization/-sation"	四
civilian	""	四
claim	""	四
clamp	""	六
clan	""	六
clap	""	四
clarity	"clarify,clarification"	四
clash	""	四
clasp	""	六
class	""	四
classic	"classical"	四
classify	"classification,classified"	四
classmate	""	四
classroom	""	四
clause	""	四
claw	""	四
clay	""	四
clean	""	四
cleanse	""	六
clear	"clearly"	四
clearance	""	六
clear-cut	""	四
clearing	""	六
clench	""	六
clergy	""	六
clerk	"clerical"	四
clever	""	四
cliche	""	六
click	""	四
client	""	四
cliff	""	四
climate	"climatic"	四
climax	""	四
climb	""	四
cling	""	四
clinic	"clinical"	四
clip	""	四
cloak	""	六
clock	""	四
clockwise	""	四
clog	""	六
clone	""	四
close	""	四
closet	""	六
cloth	""	四
clothe	"clothing"	四
clothes	""	四
cloud	"cloudy"	四
clown	""	四
club	""	四
clue	""	四
clumsy	""	四
cluster	""	六
clutch	""	六
coach	""	四
coal	""	四
coalition	""	六
coarse	""	四
coast	"coastal"	四
coat	""	四
cocaine	""	六
cock	""	四
cockpit	""	六
cocktail	""	六
coconut	""	六
code	""	四
coexist	"coexistence"	六
coffee	""	四
cognitive	"cognition"	六
coherent	"coherence"	四
cohesion	"cohesive"	四
coil	""	四
coin	"coinage"	四
coincide	"coincidence"	六
cold	""	四
collaborate	"collaboration,collaborative"	四
collapse	""	四
collar	""	四
colleague	""	四
collect	"collection,collective"	四
college	""	四
collide	"collision"	六
colon	"semi-colon"	四
colonel	""	六
colony	"colonial,colonialism,colonize/-ise"	四
colo(u)r	"colo(u)rful"	四
column	"columnist"	四
comb	""	四
combat	"combative"	四
combine	"combination"	四
come	""	四
comedy	""	四
comet	""	六
comfort	"comfortable"	四
comic	""	六
comma	""	四
command	"commander"	四
commemorate	"commemoration"	六
commence	"commencement"	四
commend	"commendation"	六
comment	"commentary,commentator"	四
commerce	"commercial,commercialize/-ise"	四
commission	""	四
commit	"commitment"	四
committee	""	四
commodity	""	四
common	""	四
commonplace	""	四
commonwealth	""	六
communicate	"communication,communicative"	四
commune	"communist,communism"	四
community	""	四
commute	"commuter"	四
compact	""	四
companion	"companionship"	四
company	""	四
compare	"comparison,comparative,comparable"	四
compartment	""	六
compass	""	四
compassion	"compassionate"	六
compatible	"compatibility"	四
compel	"compelling"	四
compensate	"compensation,compensatory"	四
compete	"competition,competitive,competitor"	四
competent	"competence"	四
compile	"compilation"	六
complacent	"complacency"	六
complain	"complaint"	四
complement	"complementary"	六
complete	"completion"	四
complex	"complexity"	四
complexion	""	六
complicate	"complicated,complication"	四
compliment	"complimentary"	六
comply	"compliance"	四
component	""	四
compose	"composition,composer"	四
composite	""	六
compound1	""	四
compound2	""	四
comprehend	"comprehension"	四
comprehensive	""	四
compress	"compression"	六
comprise	""	四
compromise	""	四
compulsory	""	四
compute	"computer,computerize/-ise,computation"	四
comrade	""	四
conceal	"concealment"	四
concede	"concession"	六
conceit	"conceited"	六
conceive	"conception"	六
concentrate	"concentration"	四
concept	"conceptual"	四
concern	"concerned,concerning"	四
concert	"concerted"	四
concise	""	六
conclude	"conclusion,conclusive"	四
concrete	""	四
concurrent	""	六
condemn	"condemnation"	四
condense	"condensation"	四
condition	"conditional,conditioner"	四
condolence	""	六
conducive	""	六
conduct	"conductor"	四
confederation	"confederate"	六
confer	""	六
conference	""	四
confess	"confession"	四
confide	""	六
confidence	"confident,confidential"	四
configuration	""	六
confine	"confinement"	四
confirm	"confirmation"	四
conflict	""	四
conform	"conformity"	四
confront	"confrontation"	四
Confucian	"Confucianism"	四
confuse	"confusion"	四
congratulate	"congratulation,congratulatory"	四
congregate	"congregation"	六
congress	"congressional"	四
conjunction	""	四
connect	"connection/-xion"	四
connotation	""	六
conquer	"conqueror,conquest"	四
conscience	""	四
conscientious	""	四
conscious	"consciousness"	四
consecutive	""	六
consensus	""	四
consent	""	四
consequence	"consequent,consequently"	四
conservative	""	四
conserve	"conservation"	六
consider	"consideration,considering"	四
considerable	""	四
considerate	""	四
consist	""	四
consistent	"consistency"	四
console	"consolation"	六
consolidate	"consolidation"	四
conspicuous	""	六
conspire	"conspiracy"	六
constant	""	四
constituent	"constituency"	六
constitute	""	四
constitution	"constitutional"	四
constrain	"constraint"	六
construct	"construction"	四
consulate	"consul"	六
consult	"consultation,consultative,consultant"	四
consume	"consumer,consumption"	四
contact	""	四
contagious	""	六
contain	"container,containment"	四
contaminate	"contamination"	四
contemplate	"contemplation,contemplative"	六
contemporary	""	四
contempt	"contemptible"	四
contend	"contention,contentious"	四
content1	""	四
content2	"contented"	四
contest	"contestant"	四
context	"contextual"	四
continent	"continental"	四
contingent	""	六
continue	"continuation,continual,continuous,continuity"	四
contract1	"contractor"	四
contract2	"contraction"	四
contradict	"contradiction,contradictory"	四
contrary	""	四
contrast	""	四
contribute	"contribution,contributor"	四
contrive	""	六
control	""	四
controversy	"controversial"	四
convene	""	六
convenient	"convenience"	四
convention	"conventional"	四
converge	"convergence"	六
converse1	"conversation"	四
converse2	""	六
convert	"conversion,convertible"	四
convey	"conveyance"	四
convict	"conviction"	六
convince	"convincing"	四
convoy	""	六
cook	"cooker"	四
cookie	""	四
cool	""	四
cooperate	"cooperation,cooperative"	四
coordinate	"coordination,coordinator"	四
cop	""	四
cope	""	四
copper	""	四
copy	""	四
copyright	""	四
coral	""	六
cord	""	四
cordial	"cordiality"	六
core	""	四
cork	""	六
corn	""	四
corner	""	四
cornerstone	""	四
corporal	""	六
corporation	"corporate"	四
corps	""	四
corpse	""	六
correct	"correction,corrective"	四
correlate	"correlation,correlative"	六
correspond	"correspondence,correspondent,corresponding"	四
corridor	""	四
corrode	"corrosion"	六
corrupt	"corruption"	四
cosmetic	""	六
cosmopolitan	""	六
cosmos	"cosmic"	四
cost	"costly"	四
costume	""	四
cottage	""	四
cotton	""	四
couch	""	四
cough	""	四
could	""	四
council	"council(l)or"	四
counsel	"counsel(l)or"	四
count	""	四
countdown	""	四
counter	""	四
counteract	"counteraction"	六
counterfeit	""	六
counterpart	""	四
country	""	四
countryside	""	四
county	""	四
coup(d'état)	""	六
couple	""	四
coupon	""	四
courage	"courageous"	四
course	""	四
court1	""	四
court2	""	四
courtesy	""	六
courtyard	""	四
cousin	""	四
cover	"coverage"	四
cow	""	四
coward	"cowardly,cowardice"	四
cowboy	""	四
cozy/-sy	""	六
crab	""	四
crack	""	四
crackdown	""	六
cracker	""	四
cradle	""	六
craft	""	四
cram	""	六
crane	""	四
crash	""	四
crate	""	六
crave	""	六
crawl	""	四
crazy	"craze"	四
cream	"creamy"	四
create	"creation,creative,creator"	四
creature	""	四
credential	""	六
credible	"credibility"	六
credit	"creditable"	四
creep	""	四
crew	""	四
cricket	""	六
crime	"criminal"	四
cripple	""	六
crisis	""	四
crisp	""	六
criterion	""	四
criticize/-ise	"criticism,critic,critical"	四
crocodile	""	四
crop	""	四
cross	"crossing"	四
crouch	""	六
crow	""	六
crowd	"crowded"	四
crown	""	四
crucial	""	四
crude	""	六
cruel	"cruelty"	四
cruise	"cruiser"	四
crumble	""	六
crunch	""	六
crush	""	四
crust	""	六
cry	""	四
crystal	""	四
cub	""	六
cube	"cubic"	四
cucumber	""	四
cue	""	四
cuisine	""	六
culminate	"culmination"	六
cult	""	六
cultivate	"cultivation"	四
culture	"cultural"	四
cumulative	""	六
cunning	""	六
cup	""	四
cupboard	""	四
curb	""	四
cure	"curable"	四
curfew	""	六
curious	"curiosity"	四
curl	""	四
currency	""	四
current	"currently"	四
curriculum	""	四
curse	""	四
curtail	""	六
curtain	""	四
curve	""	四
cushion	""	四
custody	""	六
custom	"customary"	四
customer	""	四
customs	""	四
cut	""	四
cute	""	四
cyberspace	""	四
cycle	"cycling,cyclist"	四
cylinder	""	六
cynical	"cynicism"	六
dad(dy)	""	四
daily	""	四
dairy	""	四
dam	""	四
damage	""	四
damn	""	四
damp	"dampen"	四
dance	""	四
danger	"dangerous"	四
dare	"daring"	四
dark	"darkness,darken"	四
darling	""	四
dart	""	六
dash	""	四
data	"datum"	四
database	""	四
date1	"dating"	四
date2	""	四
daughter	""	四
dawn	""	四
day	"daily"	四
daylight	""	四
dazzle	""	六
dead	""	四
deadline	""	四
deadlock	""	六
deadly	""	四
deaf	""	四
deal1	"dealer,dealing"	四
deal2	""	四
dean	""	四
dear	""	四
death	""	四
debate	""	四
debris	""	六
debt	"debtor"	四
debut	""	六
decade	""	四
decay	""	四
deceive	"deceit,deception,deceptive"	四
December	""	四
decent	""	四
decide	"decision,decisive"	四
decimal	""	六
deck	""	四
declare	"declaration,declarative"	四
decline	""	四
decorate	"decoration,decorative"	四
decrease	""	四
decree	""	六
dedicate	"dedication"	六
deduce	"deducible"	六
deduct	"deduction,deductive,deductible"	六
deed	""	四
deem	""	四
deep	"deeply,depth"	四
deer	""	四
default	""	六
defeat	""	四
defect1	"defective"	四
defect2	"defection"	四
defend	"defense/-ce,defensive,defendant"	四
defer	""	六
deficient	"deficiency"	四
deficit	""	四
define	"definition"	四
definite	"definitely"	四
defy	"defiance,defiant"	四
degenerate	"degeneration"	六
degrade	"degradation"	六
degree	""	四
delay	""	四
delegate	"delegation"	四
delete	"deletion"	四
deliberate	"deliberation"	四
delicacy	""	六
delicate	""	四
delicious	""	四
delight	"delightful"	四
deliver	"delivery"	四
delude	"delusion"	六
demand	"demanding"	四
democracy	"democratic,democrat"	四
demographic	""	六
demonstrate	"demonstration/demo,demonstrative"	四
denote	"denotation"	六
denounce	"denunciation"	六
dense	"density"	四
dent	""	四
dental	""	四
dentist	""	四
deny	"denial"	四
depart	"departure"	四
department	""	四
depend	"dependent,dependence,dependable"	四
depict	"depiction"	六
deplete	"depletion"	六
deplore	""	六
deploy	"deployment"	六
deport	"deportation"	六
deposit	""	四
depot	""	六
depreciate	"depreciation"	六
depress	"depression"	四
deprive	"deprivation"	四
depth	""	四
deputy	""	四
derail	"derailment"	六
deregulate	"deregulation"	六
derive	"derivative,derivation"	四
descend	"descent,descendant"	四
describe	"description,descriptive"	四
desert1	""	四
desert2	"desertion"	四
deserve	""	四
design	"designer"	四
designate	"designation"	六
desire	"desirable,desirability,desirous"	四
desk	""	四
desktop	""	四
desolate	""	六
despair	"desperate"	四
despatch	""	四
despise	""	六
despite	""	四
dessert	""	四
destination	""	四
destiny	"destined"	六
destroy	"destruction,destructive"	四
detach	"detached,detachment"	六
detail	"detailed"	四
detain	"detention"	六
detect	"detection,detective"	四
deter	"deterrent"	六
detergent	""	六
deteriorate	"deterioration"	四
determine	"determination,determined"	四
detriment	"detrimental"	六
devastate	"devastating,devastation"	六
develop	"development,developmental,developer"	四
deviate	"deviation"	六
device	""	四
devil	""	四
devise	""	四
devote	"devotion"	四
devour	""	六
dew	""	四
diabetes	""	四
diagnose	"diagnosis"	四
diagram	""	四
dial	""	四
dialect	""	四
dialog(ue)	""	四
diameter	""	四
diamond	""	四
diary	""	四
dictate	"dictation,dictator"	四
dictionary	""	四
die	"dying"	四
diesel	""	六
diet	"dietary"	四
differ	"difference,different"	四
differentiate	"differentiation"	六
difficult	"difficulty"	四
diffuse	"diffusion"	六
dig	""	四
digest	"digestion,digestive"	四
digit	"digital"	四
dignity	"dignify"	四
dilemma	""	四
diligent	"diligence"	四
dilute	"dilution"	六
dim	""	四
dime	""	四
dimension	"dimensional"	四
diminish	""	六
dine	"diner"	四
dinner	""	四
dinosaur	""	六
dioxide	""	四
dip	""	四
diploma	""	四
diplomat	"diplomatic,diplomacy"	四
direct	"direction,director"	四
directory	""	六
dirt	"dirty"	四
disable	"disabled,disability"	四
disagree	"disagreement"	四
disappear	"disappearance"	四
disappoint	"disappointment,disappointing"	四
disapprove	"disapproval"	四
disarm	"disarmament"	六
disaster	"disastrous"	四
discard	""	四
discern	""	六
discharge	""	四
discipline	"disciplined,disciplinary"	四
disclose	"disclosure"	六
disco	""	四
discord	""	六
discount	""	四
discourage	""	四
discourse	""	六
discover	"discovery"	四
discreet	""	六
discrepancy	""	六
discriminate	"discrimination,discriminatory"	四
discuss	"discussion"	四
disease	""	四
disguise	""	四
disgust	"disgusting"	四
dish	""	四
disintegrate	"disintegration"	四
disk/disc	""	四
dislike	""	四
dismantle	""	六
dismay	""	六
dismiss	"dismissal"	四
disorder	""	四
dispatch/despatch	""	六
dispense	""	六
disperse	""	六
displace	"displacement"	六
display	""	四
dispose	"disposal"	四
disposition	""	六
dispute	"disputable"	四
disregard	""	六
disrupt	"disruptive,disruption"	四
dissent	""	六
dissertation	""	六
dissident	""	六
dissolve	""	四
distance	"distant"	四
distil(l)	""	六
distinct	"distinction,distinctive"	四
distinguish	"distinguishable"	四
distort	"distortion"	六
distract	"distraction"	四
distress	"distressful"	四
distribute	"distribution,distributive"	四
district	""	四
disturb	"disturbance"	四
ditch	""	四
dive	""	四
diverse	"diversify,diversity"	四
divert	"diversion"	六
divide	"division,divisive"	四
dividend	""	六
divine	""	六
divorce	""	四
dizzy	""	四
do	""	四
dock	""	四
doctor	"doctorate,doctoral"	四
doctrine	""	六
document	"documentary"	四
dodge	""	六
dog	""	四
dogma	""	六
dole	""	六
doll	""	四
dollar	""	四
dolphin	""	四
domain	""	六
dome	""	六
domestic	""	四
dominate	"domination,dominance,dominant"	四
donate	"donation,donor"	四
donkey	""	四
doom	""	四
door	""	四
dormitory/dorm	""	四
dose	"dosage"	四
dot	""	四
double	""	四
doubt	"doubtful,doubtless"	四
dough	""	六
dove	""	四
down	""	四
downgrade	""	六
download	""	四
downstairs	""	四
downtown	""	四
downward	"downwards"	四
doze	""	六
dozen	""	四
draft	""	四
drag	""	四
dragon	""	四
drain	"drainage"	四
drama	"dramatic,dramatically"	四
drastic	"drastically"	四
draw	"drawing"	四
drawback	""	六
drawer	""	四
dread	"dreadful"	六
dream	"dreamy"	四
dress	""	四
dressing	""	六
drift	""	四
drill	""	四
drink	""	四
drip	""	四
drive	"driver"	四
drop	""	四
dropout	""	四
drought	""	四
drown	""	四
drug	""	四
drum	""	四
drunk	"drunken,drunkard"	四
dry	"dryer"	四
dual	""	四
dub	""	六
dubious	""	六
duck	""	四
due	"duly"	四
dull	""	四
dumb	""	四
dump	""	四
duplicate	"duplication"	六
durable	"durability"	四
duration	""	四
during	""	四
dusk	""	四
dust	"dusty"	四
duty	""	四
dwarf	""	六
dwell	"dweller,dwelling"	六
dye	""	四
dynamic	"dynamics"	四
dynasty	""	四
each	""	四
eager	""	四
eagle	""	四
ear	""	四
early	""	四
earn	"earnings"	四
earnest	""	四
earth	""	四
earthquake	""	四
ease	""	四
east	"eastern"	四
Easter	""	六
easy	"easily"	四
easy-going	""	四
eat	""	四
eccentric	""	六
echo	""	四
eclipse	""	六
ecology	"ecological"	四
economics	"economist"	四
economy	"economic,economical"	四
ecosystem	""	六
edge	""	四
edible	""	六
edit	"editor,edition"	四
editorial	""	四
educate	"education,educational,educator"	四
effect	"effective"	四
efficient	"efficiency"	四
effort	""	四
egg	""	四
eggplant	""	四
ego	"egoism,egoist"	六
eight	""	四
eighteen	""	四
eighth	""	四
eighty	""	四
either	""	四
eject	"ejection"	六
elaborate	"elaboration"	六
elapse	""	六
elastic	"elasticity"	六
elbow	""	四
elder	"elderly"	四
elect	"election,elective"	四
electoral	"electorate"	六
electricity	"electric(al),electrician"	四
electron	"electronic,electronically,electronics"	四
elegant	"elegance"	四
element	""	四
elementary	""	四
elephant	""	四
elevate	"elevation,elevator"	四
eleven	""	四
elicit	""	六
eligible	"eligibility"	六
eliminate	"elimination"	四
elite	""	四
eloquent	"eloquence"	六
else	""	四
elsewhere	""	四
email	""	四
emancipate	"emancipation"	六
embargo	""	六
embark	""	六
embarrass	"embarrassment"	四
embassy	""	四
embed	""	六
embody	"embodiment"	六
embrace	""	四
embroidery	""	六
emerge	"emergence"	四
emergency	""	四
emigrate	"emigration,emigrant"	六
eminent	"eminence"	六
emit	"emission"	四
emotion	"emotional"	四
emperor	"empress"	四
emphasis	"emphasize/-ise,emphatic"	四
empire	""	四
empirical	""	六
employ	"employment,employer,employee"	四
empty	"emptiness"	四
emulate	"emulation"	六
enable	""	四
enact	"enactment"	六
enclose	"enclosure"	六
encounter	""	四
encourage	"encouragement,encouraging"	四
encyclop(a)edia	""	六
end	"ending,endless"	四
endanger	""	四
endeavo(u)r	""	六
endorse	"endorsement"	六
endow	"endowment"	六
endure	"endurance"	四
enemy	""	四
energy	"energetic,energetically"	四
enforce	"enforcement"	四
engage	"engagement"	四
engine	""	四
engineer	"engineering"	四
enhance	"enhancement"	四
enjoy	"enjoyable,enjoyment"	四
enlarge	""	四
enlighten	"enlightenment,enlightening"	四
enlist	""	六
enormous	""	四
enough	""	四
enquire	"enquiry"	四
enrich	""	四
enrol(l)	"enrol(l)ment"	四
ensue	""	六
ensure	""	四
entail	""	六
enter	"entrance,entry"	四
enterprise	"enterprising"	四
entertain	"entertainment,entertaining"	四
enthusiasm	"enthusiastic,enthusiastically,enthusiast"	四
entire	"entirety"	四
entitle	""	四
entity	""	六
entrepreneur	"entrepreneurial"	四
entrust	""	六
envelop	""	六
envelope	""	四
environment	"environmental,environmentalist"	四
envisage	""	六
envoy	""	六
envy	"envious"	四
epic	""	六
epidemic	""	六
episode	""	四
epoch	""	六
equal	"equally,equality"	四
equate	"equation"	六
equator	""	六
equip	"equipment"	四
equity	"equitable"	六
equivalent	"equivalence"	四
era	""	四
eradicate	"eradication"	六
erase	"eraser"	四
erect	"erection"	六
erode	"erosion,erosive"	六
err	"error,erroneous"	四
errand	""	六
erupt	"eruption"	六
escalate	"escalation,escalator"	六
escape	""	四
escort	""	六
especially	""	四
essay	"essayist"	四
essence	"essential"	四
establish	"establishment"	四
estate	""	四
esteem	""	六
esthetic/aesthetic	"esthetics/aesthetics"	六
estimate	"estimation"	四
eternal	"eternity"	四
ethic	"ethics"	四
ethnic	""	四
etiquette	""	六
euro	""	四
evacuate	"evacuation"	六
evade	"evasive,evasion"	六
evaluate	"evaluation"	四
evaporate	"evaporation"	六
eve	""	四
even	"evenly"	四
evening	""	四
event	"eventful,eventually,eventual,eventuality"	四
ever	""	四
every	""	四
everybody	""	四
everyday	""	四
everyone	""	四
everything	""	四
everywhere	""	四
evident	"evidence"	四
evil	""	四
evoke	""	六
evolve	"evolution,evolutionary"	四
exact	""	四
exaggerate	"exaggeration"	四
examine	"exam(ination),examiner,examinee"	四
example	"exemplary,exemplify"	四
exceed	"exceedingly"	四
excel	""	四
excellent	"excellence"	四
except	""	四
exception	"exceptional"	四
excerpt	""	六
excess	"excessive"	四
exchange	""	四
excite	"exciting,excitement"	四
exclaim	"exclamation,exclamatory"	四
exclude	"exclusion,exclusive"	四
excursion	""	四
excuse	""	四
execute	"execution,executive"	四
exempt	"exemption"	六
exercise	""	四
exert	"exertion"	四
exhaust	"exhaustion,exhaustive"	四
exhibit	"exhibition"	四
exile	""	四
exist	"existence,existent,existing"	四
exit	""	四
exotic	""	六
expand	"expansion,expansive"	四
expect	"expectation,expectancy"	四
expedition	""	六
expel	""	四
expend	"expenditure"	四
expense	"expensive"	四
experience	"experienced"	四
experiment	"experimental"	四
expert	""	四
expertise	""	四
expire	"expiration"	六
explain	"explanation,explanatory"	四
explicit	""	四
explode	"explosion,explosive"	四
exploit	"exploitation"	四
explore	"exploration"	四
exponent	""	六
export	"exportation"	四
expose	"exposure"	四
exposition	""	六
express	"expression,expressive"	四
expressway	""	四
exquisite	""	六
extend	"extension,extensive,extended"	四
extent	""	四
exterior	""	四
external	""	四
extinct	"extinction"	六
extinguish	""	四
extra	""	四
extract	"extraction"	六
extraordinary	""	四
extravagant	"extravagance"	六
extreme	"extremity"	四
eye	""	四
eyebrow	""	四
eyesight	""	四
fable	""	四
fabric	""	四
fabricate	"fabrication"	六
fabulous	""	六
face	"facial"	四
facet	""	六
facility	"facilitate,facilitation"	四
fact	"factual"	四
faction	""	六
factor	""	四
factory	""	四
faculty	""	四
fade	""	四
fail	"failure"	四
faint	""	四
fair1	"fairly"	四
fair2	""	四
fairy	""	四
faith	"faithful"	四
fake	""	四
fall1	""	四
fall2	""	四
false	"falsehood"	四
fame	"famous"	四
familiar	"familiarity,familiarize/-ise"	四
family	""	四
famine	""	四
fan	""	四
fancy	""	四
fantasy	"fantastic"	四
far	""	四
fare	""	四
farewell	""	四
farm	"farmer,farming"	四
farther	""	四
fascinate	"fascinating,fascination"	四
fascist	"fascism"	六
fashion	"fashionable"	四
fast	""	四
fasten	""	四
fat	""	四
fatal	"fatality"	四
fate	""	四
father	"fatherly"	四
fatigue	""	四
fault	"faulty"	四
favo(u)r	"favo(u)rable,favo(u)rite"	四
fax	""	四
fear	"fearful"	四
feasible	"feasibility"	四
feast	""	六
feat	""	六
feather	""	四
feature	""	四
February	""	四
federal	""	四
federation	""	四
fee	""	四
feeble	""	六
feed	""	四
feedback	""	四
feel	"feeling"	四
fellow	"fellowship"	四
female	""	四
feminine	"feminism,feminist"	六
fence	""	四
ferry	""	四
fertile	"fertility,fertilizer/-iser"	四
festival	""	四
fetch	""	四
fever	"feverish"	四
few	""	四
fiber/-bre	""	四
fiction	"fictional"	四
field	""	四
fierce	""	四
fifteen	""	四
fifth	""	四
fifty	""	四
fight	""	四
figure	"figurative"	四
file	""	四
fill	"filling"	四
film	""	四
filter	""	四
final	"finally,finalize/-ise"	四
finance	"financial"	四
find	"finding"	四
fine1	""	四
fine2	""	四
finger	""	四
fingerprint	""	四
finish	""	四
finite	""	六
fire	""	四
fireman	""	四
fireplace	""	四
fireworks	""	四
firm1	""	四
firm2	""	四
first	"firstly"	四
fiscal	""	六
fish	"fishing,fisherman"	四
fist	""	四
fit	""	四
five	""	四
fix	"fixed,fixture,fixation"	四
flag	""	四
flame	""	四
flank	""	六
flap	""	六
flare	""	六
flash	""	四
flat1	""	四
flat2	""	四
flatter	"flattery"	六
flavo(u)r	""	四
flaw	"flawless"	四
flee	""	四
fleet	""	四
flesh	""	四
flexible	"flexibility"	四
fling	""	六
flip	""	六
flirt	"flirtation"	六
float	""	四
flock	""	四
flood	""	四
floor	""	四
flour	""	四
flourish	""	四
flow	""	四
flower	""	四
fluctuate	"fluctuation"	四
fluent	"fluency"	四
fluid	""	四
flush	""	六
flutter	""	六
fly1	"flight"	四
fly2	""	四
foam	""	六
focus	""	四
foe	""	六
fog	"foggy"	四
foil	""	六
fold	""	四
folk	""	四
folklore	""	六
follow	"following"	四
fond	""	四
food	""	四
fool	"foolish"	四
foot	""	四
football	""	四
footprint	""	四
for	""	四
forbid	""	四
force	"forceful"	四
forecast	""	四
forehead	""	四
foreign	"foreigner"	四
foremost	""	四
foresee	"foreseeable"	四
foresight	""	四
forest	"forestry"	四
foretell	""	六
forever	""	四
forfeit	""	六
forge	"forgery"	四
forget	"forgetful,forgettable"	四
forgive	"forgiving"	四
fork	""	四
form	"formation"	四
formal	"formality"	四
format	""	四
former	""	四
formidable	""	六
formula	""	四
formulate	"formulation"	四
fort	""	六
forth	""	四
forthcoming	""	四
fortify	"fortification"	六
fortnight	""	六
fortune	"fortunate"	四
forty	""	四
forum	""	四
forward	""	四
fossil	""	四
foster	""	六
foul	""	六
found	"founding,founder"	四
foundation	""	四
fountain	""	四
four	""	四
fourteen	""	四
fox	""	四
fraction	""	四
fracture	""	六
fragile	"fragility"	六
fragment	"fragmentation,fragmentary"	四
fragrant	"fragrance"	六
frame	""	四
framework	""	四
franchise	""	六
frank	""	四
frantic	"frantically"	六
fraud	"fraudulent"	六
free	"freedom"	四
freeway	""	四
freeze	""	四
freight	""	四
frequent	"frequency"	四
fresh	""	四
freshman	""	四
friction	""	六
Friday	""	四
friend	"friendly,friendship"	四
fright	"frighten"	四
fringe	""	六
frog	""	四
from	""	四
front	""	四
frontier	""	四
frost	"frosty"	四
frown	""	六
fruit	"fruitful"	四
frustrate	"frustration,frustrating"	四
fry	""	四
fuck	""	四
fuel	""	四
fulfil(l)	"fulfil(l)ment"	四
full	""	四
fun	"funny"	四
function	"functional"	四
fund	"funding"	四
fundamental	""	四
funeral	""	四
fur	""	四
furnace	""	四
furnish	""	四
furniture	""	四
further	""	四
furthermore	""	四
fury	"furious"	六
fuse	""	六
fusion	""	六
fuss	""	四
futile	"futility"	六
future	""	四
gadget	"gadgetry"	四
gain	""	四
galaxy	""	六
gallery	""	四
gallon	""	四
gamble	""	四
game	""	四
gang	"gangster"	四
gaol	""	四
gap	""	四
garage	""	四
garbage	""	四
garden	"gardener,gardening"	四
garlic	""	六
garment	""	四
gas	""	四
gasoline/petrol	""	四
gasp	""	六
gate	""	四
gather	"gathering"	四
gauge	""	六
gay	""	四
gaze	""	四
gear	""	四
gender	""	四
gene	"genetic,genetically"	四
general	"generally,generalize/-ise"	四
generate	"generator"	四
generation	""	四
generous	"generosity"	四
genius	""	四
genre	""	六
gentle	""	四
gentleman	""	四
genuine	""	四
geography	"geographic,geographically"	四
geology	"geological,geologically"	四
geometry	"geometric,geometrically"	四
germ	""	四
gesture	""	四
get	""	四
ghost	""	四
giant	"gigantic"	四
gift	"gifted"	四
giggle	""	六
girl	""	四
give	""	四
given	""	四
glacier	""	六
glad	""	四
glamo(u)r	"glamo(u)rous"	六
glance	""	四
gland	""	六
glare	""	六
glass	""	四
gleam	""	六
glide	"glider"	六
glimpse	""	四
glitter	""	六
globe	"global,globalize/-ise"	四
gloom	"gloomy"	四
glory	"glorious"	四
glossary	""	六
glove	""	四
glow	""	四
glue	""	四
go	""	四
goal	""	四
goat	""	四
god	""	四
gold	"golden"	四
golf	""	四
good	""	四
goodby(e)	""	四
goodness	""	四
goods	""	四
goose	""	四
gorge	""	六
gorgeous	""	四
gospel	""	六
gossip	""	四
govern	"government,governor"	四
gown	""	四
grab	""	四
grace	"graceful,gracious"	四
grade	""	四
gradual	"gradually"	四
graduate	"graduation"	四
grain	""	四
gram(me)	""	四
grammar	"grammatical"	四
grand	""	四
grandchild	"grandchildren,grandson,granddaughter"	四
grandparent	"grandfather,grandmother"	四
grant	"granted"	四
grape	""	四
graph	"graphic,graphically"	四
grasp	""	四
grass	"grassy"	四
grateful	""	四
gratitude	""	四
grave	""	四
gravitation	""	四
gravity	""	四
gray/grey	""	四
graze	""	六
grease	"greasy"	六
great	""	四
greed	"greedy"	六
green	""	四
greenhouse	""	四
greet	"greeting"	四
grid	""	六
grief	"grieve,grievous"	四
grill	""	六
grim	""	六
grin	""	四
grind	""	四
grip	""	四
groan	""	六
grocer	"grocery"	四
groove	""	六
grope	""	六
gross	""	四
ground	""	四
group	""	四
grow	"growth"	四
guarantee	""	四
guard	"guardian"	四
guess	""	四
guest	""	四
guide	"guidance"	四
guideline	""	四
guilt	"guilty"	四
guitar	"guitarist"	四
gulf	""	四
gum	""	四
gun	""	四
gut	""	四
guy	""	四
gymnasium/gym	""	四
habit	"habitual"	四
habitat	""	四
hack1	"hacker"	四
hack2	""	四
hail1	""	四
hail2	""	四
hair	"hairy"	四
half	""	四
halfway	""	四
hall	""	四
halt	""	四
ham	""	四
hamburger/burger	""	四
hammer	""	四
hamper	""	六
hand	"handful"	四
handbook	""	四
handicap	"handicapped"	四
handicraft	""	六
handle	""	四
handsome	""	四
handwriting	""	四
handy	""	四
hang	""	四
happen	""	四
happy	"happiness,happily"	四
harass	"harassment"	六
harbo(u)r	""	四
hard	"harden"	四
hardly	""	四
hardship	""	四
hardware	""	四
hardy	""	六
harm	"harmful,harmless"	四
harmony	"harmonious"	四
harness	""	四
harsh	""	四
harvest	""	四
haste	"hasty,hasten"	四
hat	""	四
hatch	""	四
hate	"hatred,hateful"	四
haul	""	四
haunt	""	四
have	""	四
haven	""	六
havoc	""	六
hawk	""	六
hay	""	四
hazard	"hazardous"	四
haze	"hazy"	四
he	""	四
head	""	四
headache	""	四
heading	""	四
headline	""	四
headmaster	"headmistress"	四
headquarters	""	四
heal	""	四
health	"healthy,healthful"	四
heap	""	四
hear	"hearing"	四
heart	"hearty"	四
heartfelt	""	四
heat	"heated,heating"	四
heave	""	六
heaven	""	四
heavy	""	四
hectare	""	四
hectic	""	六
hedge	""	四
heel	""	四
height	"heighten"	四
heir	"heiress"	四
helicopter	""	四
hell	""	四
hello	""	四
helmet	""	六
help	"helpful,helpless,helplessly"	四
hemisphere	""	六
hen	""	四
hence	""	四
henceforth	""	六
her	""	四
herald	""	六
herb	"herbal"	六
herd	""	四
here	""	四
hereby	""	四
heritage	""	四
hero/heroine	"heroic,heroism"	四
heroin	""	六
hers	""	四
herself	""	四
hesitate	"hesitation,hesitant"	四
hi	""	四
hibernate	"hibernation"	六
hide	"hiding"	四
hierarchy	"hierarchical"	六
high	"highly"	四
highlight	""	四
high-tech	""	四
highway	""	四
hijack	""	四
hike	""	六
hill	"hilly"	四
him	""	四
himself	""	四
hinder	"hindrance"	四
hinge	""	六
hint	""	四
hip	""	四
hire	""	四
his	""	四
history	"historic,historical,historian"	四
hit	""	四
hitherto	""	六
hive	""	六
hobby	""	四
hockey	""	六
hoist	""	六
hold	""	四
hole	""	四
holiday	""	四
hollow	""	四
holy	"holiness"	四
home	"homeless,homely"	四
homeland	""	四
homework	""	四
homogeneous	""	六
homosexual/homo	""	四
honest	"honesty"	四
honey	""	四
honeymoon	""	四
hono(u)r	"hono(u)rable,hono(u)rary"	四
hook	""	四
hop	""	六
hope	"hopeful,hopeless"	四
horizon	"horizontal"	四
horn	""	四
horror	"horrible,horrify"	四
horse	""	四
horsepower	""	四
hose	""	六
hospital	"hospitalize"	四
hospitable	"hospitality"	四
host1	"hostess"	四
host2	""	四
hostage	""	六
hostile	"hostility"	四
hot	""	四
hotdog	""	四
hotel	""	四
hound	""	六
hour	"hourly"	四
house	"housing"	四
household	""	四
housewife	""	四
housework	""	四
hover	""	六
how	""	四
however	""	四
howl	""	六
huddle	""	六
hug	""	四
huge	""	四
hum	""	六
human	"humanity"	四
humane	"humanism,humanist,humanitarian"	六
humble	"humbly"	四
humid	"humidity"	六
humiliate	"humiliation"	六
humo(u)r	"humo(u)rous"	四
hundred	""	四
hunger	"hungry"	四
hunt	"hunting,hunter"	四
hurdle	""	六
hurl	""	六
hurricane	""	六
hurry	"hurriedly"	四
hurt	"hurtful"	四
husband	""	四
hut	""	四
hybrid	""	六
hydrogen	""	四
hygiene	"hygienic"	六
hyphen	""	四
hypocrisy	"hypocritical,hypocrite"	六
hypothesis	"hypothetical"	六
hysterical	"hysteria"	六
I	""	四
ice	"icy"	四
iceberg	""	六
ice-cream	""	四
icon	""	六
idea	""	四
ideal	"idealistic,idealism"	四
identify	"identification"	四
identity	"identical"	四
ideology	"ideological"	六
idiom	"idiomatic"	四
idiot	"idiotic"	六
idle	"idly"	四
idol	""	六
if	""	四
ignite	"ignition"	六
ignorant	"ignorance"	四
ignore	""	四
ill	"illness"	四
illegal	""	四
illicit	""	六
illiterate	"illiteracy"	六
illuminate	"illumination"	六
illusion	"illusory"	四
illustrate	"illustration,illustrative"	四
image	"imaging"	四
imagine	"imagination,imaginative,imaginary"	四
imitate	"imitation,imitative"	四
immediate	"immediately"	四
immense	"immensely,immensity"	四
immerse	"immersion"	六
immigrate	"immigration,immigrant"	四
imminent	""	六
immune	"immunity,immunize/-ise"	四
impact	""	四
impair	""	六
impart	""	六
impatient	"impatience"	四
imperative	""	六
imperial	"imperialism,imperialist"	四
impetus	""	六
implement1	"implementation"	四
implement2	""	四
implicit	""	四
imply	"implication"	四
import	"importation"	四
important	"importance"	四
impose	"imposition,imposing"	四
impossible	"impossibility"	四
impress	"impression,impressive"	四
imprison	"imprisonment"	六
impromptu	""	六
improve	"improvement"	四
impulse	"impulsive"	四
in	""	四
inaugurate	"inauguration"	六
inborn	""	六
incentive	""	四
inch	""	四
incidence	""	四
incident	"incidental,incidentally"	四
incline	"inclined,inclination"	四
include	"inclusion,inclusive,including"	四
income	""	四
incorporate	"incorporation"	六
increase	"increasingly"	四
incredible	"incredibly"	四
incumbent	""	六
incur	""	六
indebted	""	六
indeed	""	四
indefinite	""	六
independent	"independence"	四
index	""	四
indicate	"indication,indicative,indicator"	四
indict	"indictment"	六
indifferent	"indifference"	四
indigenous	""	六
indignant	"indignation"	六
indispensable	""	四
individual	"individualism"	四
indoor	"indoors"	四
induce	"inducement"	四
indulge	"indulgence,indulgent"	六
industry	"industrial,industrialize/-ise,industrious"	四
inertia	""	六
inevitable	""	四
infant	""	四
infect	"infection,infectious"	四
infer	"inference"	四
inferior	"inferiority"	四
infinite	"infinity,infinitive"	四
inflate	"inflation"	四
inflict	"infliction"	六
influence	"influential"	四
influenza/flu	""	四
inform	"information,informative,informant"	四
infrastructure	""	四
infringe	"infringement"	六
ingenious	"ingenuity"	六
ingredient	""	四
inhabit	"inhabitant"	四
inherent	""	六
inherit	"inheritance"	四
inhibit	"inhibition"	六
initial	"initially"	四
initiate	"initiation,initiative"	四
inject	"injection"	六
injure	"injury,injurious"	四
ink	""	四
inland	""	四
inmate	""	六
inn	""	四
inner	""	四
innocent	"innocence"	四
innovate	"innovation,innovative"	四
innumerable	""	六
input	""	四
inquire/enquire	"inquiry/enquiry,inquisitive"	四
insane	"insanity"	四
insect	""	四
insert	"insertion"	四
inside	"insider"	四
insight	"insightful"	四
insist	"insistence,insistent"	四
inspect	"inspection,inspector"	四
inspire	"inspiration,inspirational"	四
instal(l)	"instal(l)ation"	四
instal(l)ment	""	四
instance	""	四
instant	"instantaneous"	四
instead	""	四
instinct	"instinctive"	四
institute	""	四
institution	"institutional"	四
instruct	"instruction,instructor,instructive"	四
instrument	"instrumental"	四
insulate	"insulation,insulator"	六
insult	""	四
insure/ensure	"insurance"	四
intact	""	四
intake	""	四
intangible	""	四
integral	""	六
integrate	"integration"	四
integrity	""	四
intellect	""	六
intellectual	""	四
intelligent	"intelligence"	四
intelligible	""	六
intend	"intention,intent,intentional"	四
intense	"intensity,intensify"	四
intensive	""	四
interact	"interaction,interactive"	四
intercourse	""	六
interest	"interesting,interested"	四
interfere	"interference"	四
interim	""	六
interior	""	四
intermediate	"intermediary"	四
intermittent	""	六
internal	""	四
international	""	四
Internet/internet	""	四
interpret	"interpretation,interpreter"	四
interrogate	"interrogation"	六
interrupt	"interruption"	四
interval	""	四
intervene	"intervention"	六
interview	"interviewer,interviewee"	四
intimate	"intimacy"	四
intimidate	"intimidation"	六
into	""	四
intricate	"intricacy"	六
intrigue	""	六
intrinsic	"intrinsically"	六
introduce	"introduction,introductory"	四
intrude	"intrusion,intruder"	四
intuition	"intuitive"	六
invade	"invasion,invader,invasive"	四
invalid1	""	六
invalid2	""	四
invaluable	""	四
invariably	""	四
invent	"invention,inventor"	四
inventory	""	六
invert	"inversion"	六
invest	"investment,investor"	四
investigate	"investigation,investigator"	四
invisible	""	四
invite	"invitation,inviting"	四
involve	"involvement,involved"	四
inward	""	四
iron	""	四
irony	"ironic(al),ironically"	四
irrational	""	四
irregular	""	四
irrespective	""	六
irrigate	"irrigation"	四
irritate	"irritation,irritating,irritable"	六
island	""	四
isle	""	六
isolate	"isolation"	四
issue	""	四
it	""	四
item	""	四
its	""	四
itself	""	四
ivory	""	六
jack	""	六
jacket	""	四
jail/gaol	""	四
jam1	""	四
jam2	""	四
January	""	四
jar1	""	四
jar2	""	四
jargon	""	六
jaw	""	四
jazz	""	四
jealous	"jealousy"	四
jeans	""	四
jeep	""	四
jelly	""	六
jeopardize/-ise	"jeopardy"	六
jerk	""	六
jet	""	四
jetlag	""	四
jewel	"jewel(l)ery/jewelry"	四
job	""	四
jockey	""	六
jog	""	四
join	""	四
joint	""	四
joke	""	四
jolly	""	六
journal	""	四
journalism	"journalist"	四
journey	""	四
joy	"joyous,joyful"	四
judge	"judg(e)ment"	四
judicial	""	六
judiciary	""	六
juice	"juicy"	四
July	""	四
jump	""	四
junction	""	六
June	""	四
jungle	""	四
junior	""	四
junk	""	四
jurisdiction	""	六
jury	"juror"	四
just1	""	四
just2	""	四
justice	""	四
justify	"justification"	四
juvenile	""	六
keen	""	四
keep	""	四
kettle	""	四
key	""	四
keyboard	""	四
kick	""	四
kid	""	四
kidnap	""	六
kidney	""	六
kill	""	四
kilogram(me)/kilo	""	四
kilometer/-tre	""	四
kin	""	四
kind	"kindness"	四
kindergarten	""	四
king	""	四
kingdom	""	四
kiss	""	四
kit	""	四
kitchen	""	四
kite	""	四
knee	""	四
kneel	""	四
knife	""	四
knight	""	六
knit	""	四
knob	""	六
knock	""	四
knot	"knotty"	四
know	"knowledge,knowledgeable"	四
knowhow	""	四
label	""	四
labo(u)r	"laborious"	四
laboratory/lab	""	四
lace	""	四
lack	""	四
lad	""	六
ladder	""	四
lady	""	四
lag	""	四
lake	""	四
lamb	""	四
lame	""	四
lamp	""	四
land	"landing"	四
landlord/landlady	""	四
landmark	""	六
landscape	""	四
lane	""	四
language	""	四
lap	""	四
laptop	""	四
large	"largely"	四
laser	""	四
lash	""	六
lass	""	四
last	"lastly"	四
late	"later"	四
lately	""	四
latitude	""	六
latter	""	四
laugh	"laughter"	四
launch	""	四
laundry	""	四
lavatory	""	四
lavish	""	六
law	"lawful"	四
lawn	""	四
lawsuit	""	六
lawyer	""	四
lay	""	四
layer	""	四
layman	""	六
layoff	""	四
layout	""	四
lazy	"laziness"	四
lead1	"leader,leadership,leading"	四
lead2	""	四
leaf	""	四
leaflet	""	六
league	""	四
leak	""	四
lean	""	四
leap	""	四
learn	"learned,learning,learner"	四
lease	""	四
least	""	四
leather	""	四
leave	""	四
lecture	"lecturer"	四
left	"leftist"	四
leg	""	四
legacy	""	六
legal	"legalize/-ise"	四
legend	"legendary"	四
legislate	"legislation,legislative,legislator"	四
legitimate	"legitimacy"	六
leisure	"leisurely"	四
lemon	"lemonade"	四
lend	""	四
lenient	"leniency"	六
lens	""	四
lesbian	""	六
less	""	四
lesson	""	四
lest	""	四
let	""	四
letter	""	四
level	""	四
lever	"leverage"	六
levy	""	六
liable	"liability"	四
liberal	""	四
liberate	"liberation"	四
liberty	""	四
library	"librarian"	四
license/-ce	""	四
lick	""	四
lid	""	四
lie1	"liar"	四
lie2	""	四
lieutenant	""	六
life	""	四
lift	""	四
light1	"lighting"	四
light2	""	四
lightning	""	四
like1	""	四
like2	"likely,likelihood"	四
likewise	""	四
lily	""	四
limb	""	四
lime	""	六
limelight	""	六
limit	"limitation,limited"	四
limp	""	六
line	"linear"	四
linen	""	六
liner	""	六
linger	""	六
linguistic	"linguistics"	六
link	"linkage"	四
lion	"lioness"	四
lip	""	四
lipstick	""	六
liquid	""	四
liquor	""	四
list	""	四
listen	"listener"	四
liter/-tre	""	四
literal	"literally"	四
literary	"literature,literate,literacy"	四
litter	""	四
little	""	四
live1	"living"	四
live2	""	四
livelihood	""	四
lively	""	四
liver	""	四
livestock	""	六
living-room	""	四
load	""	四
loaf	""	四
loan	""	四
lobby	"lobbyist"	四
local	"locality"	四
locate	"location"	四
lock	"locker"	四
locomotive	""	六
lodge	"lodging"	四
lofty	""	六
log	""	四
logic	"logical"	四
logistics	"logistic(al)"	六
logo	""	四
lonely	"loneliness"	四
long1	"length,lengthy"	四
long2	""	四
longevity	""	六
longitude	"longitudinal"	六
look	""	四
loom	""	六
loop	""	六
loophole	""	四
loose	"loosen"	四
loot	""	六
lord	""	四
lorry	""	四
lose	"loss"	四
lot	""	四
lotion	""	六
lottery	""	六
loud	"loudly"	四
lounge	""	六
love	"lovely,lover"	四
low	"lower"	四
loyal	"loyalty"	四
lubricate	"lubrication"	六
luck	"lucky"	四
lucrative	""	六
luggage	""	四
luminous	""	六
lump	""	四
lunar	""	四
lunch	"luncheon"	四
lung	""	四
lure	""	六
luxury	"luxurious"	四
lyric	"lyrical"	六
machine	"machinery"	四
mad	"madden"	四
madam	""	四
magazine	""	四
magic	"magical"	四
magistrate	""	六
magnet	"magnetic"	四
magnificent	"magnificence"	四
magnify	""	六
magnitude	""	六
maid	""	四
maiden	""	四
mail	""	四
main	""	四
mainland	""	四
mainstream	""	四
maintain	"maintenance"	四
majesty	"majestic"	六
major	"majority"	四
make	""	四
makeup	""	四
male	""	四
malice	"malicious"	六
malignant	""	六
mall	""	四
malpractice	""	六
mammal	""	四
man	"manly,manhood"	四
manage	"management,manager,managerial"	四
mandate	"mandatory"	六
maneuver/manoeuvre	""	六
manifest	"manifestation"	六
manipulate	"manipulation,manipulative"	四
mankind	""	四
manner	""	四
mansion	""	六
manual	""	四
manufacture	"manufacturer"	四
manuscript	""	六
many	""	四
map	""	四
mar	""	六
marathon	""	四
marble	""	六
March	""	四
march	""	四
margin	"marginal"	四
marine	""	四
maritime	""	六
mark	""	四
market	"marketing"	四
marry	"marriage,marital"	四
marsh	""	四
marshal	""	四
martyr	"martyrdom"	六
marvel	"marvel(l)ous"	四
Marxism	"Marxist"	四
masculine	"masculinity"	六
mask	""	四
mass	"massive"	四
massacre	""	六
massage	""	四
master	"mastery"	四
masterpiece	""	四
mat	""	四
match	""	四
mate	""	四
material	"materialism,materialist,materialize/-ise"	四
maternal	"maternity"	六
math(ematics)/maths	"mathematical"	四
matter	""	四
mature	"maturity"	四
maximum	"maximize/-ise,maximal"	四
May	""	四
may	""	四
maybe	""	四
mayor	""	四
me	""	四
meadow	""	六
meal	""	四
mean1	"meaning,meaningful"	四
mean2	""	四
mean3	""	四
means	""	四
meantime	""	四
meanwhile	""	四
measure	"measurement,measurable"	四
meat	"meaty"	四
mechanic	"mechanical,mechanics,mechanism"	四
mechanize/-ise	"mechanization/-sation"	四
medal	""	四
mediate	"mediation,mediator"	六
medical	""	四
Medicare	""	四
medication	""	六
medicine	"medicinal"	四
medieval	""	六
medium	"media"	四
meet	""	四
meeting	""	四
melody	"melodious"	六
melon	""	四
melt	""	四
member	"membership"	四
memorandum/memo	""	四
memorial	""	四
memory	"memorize/-ise"	四
menace	""	六
mend	""	四
mental	"mentality"	四
mention	""	四
mentor	""	六
menu	""	四
merchandise	""	六
merchant	""	四
mercury	""	六
mercy	"merciful"	四
mere	"merely"	四
merge	"merger"	六
merit	"meritorious"	四
merry	"merriment"	四
mess	"messy"	四
message	"messenger"	四
metabolism	"metabolic"	六
metal	"metallic"	四
metaphor	"metaphorical"	六
meter/-tre	"metric"	四
method	"methodical,methodology"	四
meticulous	""	六
metro	""	四
metropolitan	""	六
microphone	""	四
microscope	"microscopic"	四
microwave	"microwavable"	四
midday	""	四
middle	""	四
middle-class	""	四
midnight	""	四
midst	""	六
midwife	""	六
might	"mighty"	四
migrate	"migration,migrant"	四
mild	""	四
mile	"mileage"	四
milestone	""	六
militant	"militancy"	六
military	""	四
militia	""	六
milk	"milky"	四
mil	""	四
millimeter/-tre	""	四
million	"millionaire"	四
mind	""	四
mindset	""	六
mine1	""	四
mine2	"mineral,mining"	四
mine3	""	四
mingle	""	六
miniature	""	六
minimum	"minimal,minimize/-ise"	四
minister	"ministry,ministerial"	四
minor	"minority"	四
mint	""	六
minus	""	四
minute1	""	四
minute2	""	四
miracle	"miraculous"	四
mirror	""	四
miserable	"misery"	四
misfortune	""	四
mislead	"misleading"	四
miss1	""	四
miss2	""	四
missile	""	四
missing	""	四
mission	""	四
missionary	""	六
mist	"misty"	四
mistake	"mistaken"	四
mister	""	四
mistress	""	四
misunderstand	"misunderstanding"	四
mix	"mixture,mixer"	四
moan	""	六
mobile	""	四
mobilize/-ise	""	六
mock	""	六
mode	""	四
model	""	四
moderate	"moderation,moderator"	四
modern	"modernize/-ise,modernization/-sation"	四
modest	"modesty"	四
modify	"modification,modifier"	四
moist	"moisture"	四
mo(u)ld	"mo(u)ldy"	四
molecule	"molecular"	六
mom(my)	""	四
moment	"momentary,momentarily"	四
momentum	"momentous"	六
monarchy	"monarch"	六
Monday	""	四
money	"monetary"	四
monitor	""	四
monkey	""	四
monopoly	"monopolize/-ise"	六
monotony	"monotonous"	六
monster	"monstrous"	四
month	"monthly"	四
monument	"monumental"	四
mood	"moody"	四
moon	""	四
mop	""	四
moral	"morality"	四
morale	""	六
more	""	四
moreover	""	四
morning	""	四
mortal	"mortality"	六
mortgage	""	四
mosquito	""	六
most	"mostly"	四
motel	""	四
mother	"motherly"	四
motion	""	四
motivate	"motivation"	四
motive	""	四
motor	""	四
motorway	""	四
mount1	"mounting"	四
mount2	""	四
mountain	"mountainous"	四
mourn	"mourning"	六
mouse	""	四
mouth	"mouthful"	四
move	"movement"	四
movie	""	四
mow	""	六
much	""	四
mud	"muddy"	四
mug	""	四
mule	""	四
multilateral	""	六
multiple	"multiply,multiplication"	四
multitude	""	六
municipal	"municipality"	四
murder	"murderous"	四
murmur	""	六
muscle	"muscular"	四
museum	""	四
mushroom	""	四
music	"musical,musician"	四
must	""	四
mute	""	六
mutter	""	六
mutual	""	四
my	""	四
myself	""	四
mystery	"mysterious"	四
myth	"mythical,mythology"	四
nail	""	四
naive	"naivety"	六
naked	""	四
name	""	四
namely	""	四
nap	""	四
napkin	""	四
narrate	"narration,narrative,narrator"	四
narrow	"narrowly"	四
nasty	""	四
nation	"national,nationality,nationalist,nationalism"	四
nationwide	""	四
native	""	四
nature	"natural,naturally"	四
naughty	""	四
navigate	"navigation"	六
navy	"naval"	四
near	"nearly"	四
nearby	""	四
neat	""	四
necessary	"necessarily"	四
necessity	"necessitate"	四
neck	""	四
necklace	""	四
need	"needy"	四
needle	""	四
negate	"negation,negative"	四
neglect	"neglectful"	四
negligent	"negligence"	六
negligible	""	六
negotiate	"negotiation,negotiable"	四
neighbo(u)r	"neighbo(u)rhood"	四
neither	""	四
nephew	""	四
nerve	"nervous"	四
nest	""	四
net	""	四
network	"networking"	四
neutral	"neutrality,neutralize/-ise"	四
never	""	四
nevertheless	""	四
new	""	四
news	""	四
newspaper	""	四
next	""	四
nice	"nicety"	四
nickel	""	四
nickname	""	六
niece	""	四
night	"nightly"	四
nightmare	""	四
nil	""	六
nine	""	四
nineteen	""	四
ninety	""	四
ninth	""	四
nitrogen	""	六
no	""	四
noble	"nobility"	四
nobody	""	四
nod	""	四
noise	"noisy"	四
nominal	""	六
nominate	"nomination,nominee"	六
none	""	四
nonetheless	""	六
nonsense	""	四
noodle	""	四
noon	""	四
nor	""	四
norm	""	四
normal	"normally,normalize/-ise,normalization/-sation"	四
north	"northern"	四
northeast	"northeastern"	四
northwest	"northwestern"	四
nose	"nosy"	四
not	""	四
note	"notation,notable"	四
notebook	""	四
noteworthy	""	六
nothing	""	四
notice	"noticeable"	四
notify	"notification"	四
notion	"notional"	四
notorious	"notoriety"	六
notwithstanding	""	六
noun	""	四
nourish	"nourishment"	四
novel1	"novelist"	四
novel2	"novelty"	四
November	""	四
now	""	四
nowadays	""	四
nowhere	""	四
nuclear	"nucleus"	四
nude	"nudity"	四
nuisance	""	四
numb	""	六
number	""	四
numerical	""	六
numerous	""	四
nurse	""	四
nursery	""	四
nurture	""	六
nut	""	四
nutrition	"nutrient"	四
oak	""	六
oar	""	六
oath	""	六
obese	"obesity"	四
obey	"obedient,obedience"	四
object1	""	四
object2	"objection"	四
objective	""	四
oblige	"obligation,obliged,obligatory"	四
obscene	"obscenity"	六
obscure	"obscurity"	六
observatory	""	六
observe	"observation,observer,observant"	四
obsess	"obsession,obsessive"	六
obstacle	""	四
obstruct	"obstruction"	六
obtain	"obtainment"	四
obvious	"obviously"	四
occasion	"occasional,occasionally"	四
occupation	"occupational"	四
occupy	"occupancy,occupant"	四
occur	"occurrence"	四
ocean	"oceanic"	四
o'clock	""	四
October	""	四
odd	"oddity"	四
odds	""	四
odo(u)r	"odorous"	四
of	""	四
off	""	四
offend	"offense/-ce,offensive,offender"	四
offer	"offering"	四
office	""	四
officer	""	四
official	""	四
offset	""	六
offspring	""	六
often/oftentimes	""	四
oil	"oily"	四
okay	""	四
old	""	四
old-fashioned	""	四
olive	""	六
Olympic	"Olympics,Olympiad"	四
omit	"omission"	四
on	""	四
once	""	四
one	""	四
oneself	""	四
ongoing	""	四
onion	""	四
online	""	四
only	""	四
onset	""	六
onto	""	四
onward	""	四
opaque	""	六
open	"opener,opening,openly"	四
opera	""	四
operate	"operation,operational,operator"	四
operative	""	六
opinion	""	四
opportunity	""	四
oppose	"opposition,opponent"	四
opposite	""	四
oppress	"oppression,oppressive"	六
opt	"option,optional"	四
optic	"optical"	六
optimism	"optimistic,optimist"	四
optimum	"optimal"	六
or	""	四
oral	""	四
orange	""	四
orbit	"orbital"	四
orchestra	""	四
ordeal	""	六
order	"orderly"	四
ordinary	""	四
ore	""	四
organ	""	四
organic	""	四
organism	""	四
organize/-ise	"organization/-sation,organizational/-sational"	四
orient1	"orientation"	四
orient2	"oriental"	四
origin	"original,originality,originate"	四
ornament	"ornamental"	四
orphan	"orphanage"	四
orthodox	""	六
other	""	四
otherwise	""	四
ought-to	""	四
ounce	""	四
our	""	四
ours	""	四
ourselves	""	四
out	""	四
outbreak	""	四
outcome	""	四
outdated	""	四
outdoor	"outdoors"	四
outer	""	四
outfit	""	六
outgoing	""	四
outing	""	四
outlaw	""	六
outlet	""	四
outline	""	四
outlook	""	四
output	""	四
outrage	"outrageous"	六
outset	""	四
outside	"outsider"	四
outskirts	""	四
outstanding	""	四
outward	"outwards"	四
oval	""	四
oven	""	四
over	""	四
overall	""	四
overcoat	""	四
overcome	""	四
overdue	""	四
overflow	""	六
overhaul	""	六
overhead	""	四
overhear	""	四
overlap	""	六
overlook	""	四
overnight	""	四
override	""	六
overseas	""	四
oversee	""	四
oversight	""	四
overstate	""	六
overt	""	六
overtake	""	四
overthrow	""	四
overtime	""	四
overturn	""	六
overwhelm	"overwhelming,overwhelmingly"	四
owe	"owing-to"	四
owl	""	六
own	"owner,ownership"	四
ox	""	四
oxide	""	六
oxygen	""	四
ozone	""	四
pace	""	四
pack	""	四
package	""	四
packet	""	四
pact	""	六
pad	""	四
paddy	""	四
page	""	四
pain	"painful"	四
paint	"painting,painter"	四
pair	""	四
palace	""	四
pale	""	四
palm	""	四
pamphlet	""	六
pan	""	四
panda	""	四
panel	""	四
panic	""	四
panorama	"panoramic"	六
pant	""	六
pants	""	四
paper	""	四
paperback	""	四
parachute	""	六
parade	""	四
paradigm	""	六
paradise	""	六
paradox	"paradoxical"	四
paragraph	""	四
parallel	""	四
paralyze/-yse	"paralysis"	六
parameter	""	六
parasite	""	六
parcel	""	四
pardon	""	四
parent	"parental,parenting"	四
parish	""	六
park1	""	四
park2	"parking"	四
parliament	"parliamentary"	四
parole	""	六
parrot	""	六
part	"partial,partially"	四
participate	"participation,participant"	四
particle	""	四
particular	"particularly"	四
partisan	""	六
partition	""	六
partly	""	四
partner	"partnership"	四
party	""	四
pass	""	四
passage	""	四
passenger	""	四
passerby(pl.passers-by)/passer	""	六
passion	"passionate"	四
passive	""	四
passport	""	四
password	""	四
past	""	四
pasta	""	六
paste	""	四
pastime	""	四
pastry	""	六
pasture	""	六
pat	""	四
patch	""	四
patent	""	四
path	""	四
pathetic	""	六
patient1	"patience"	四
patient2	""	四
patriot	"patriotic,patriotism"	六
patrol	""	六
patron	"patronize/-ise,patronage"	六
pattern	""	四
pause	""	四
pave	"pavement"	四
paw	""	四
pay	"payment"	四
payroll	""	四
pea	""	四
peace	"peaceful"	四
peach	""	四
peak	""	四
peanut	""	四
pear	""	四
pearl	""	四
peasant	""	四
peck	""	六
peculiar	"peculiarity"	四
pedal	""	六
peddle	""	六
pedestrian	""	四
peel	""	六
peep	""	六
peer	""	四
peg	""	六
pen	""	四
penalty	"penalize/-ise"	四
pencil	""	四
pending	""	六
pendulum	""	六
penetrate	"penetration"	四
penguin	""	六
peninsula	""	六
penny	""	四
pension	"pensioner"	四
people	""	四
pepper	""	四
per	""	四
perceive	"perception,perceptive"	四
percent	"percentage"	四
perch	""	六
perfect	"perfection"	四
perform	"performance,performer"	四
perfume	""	六
perhaps	""	四
peril	"perilous"	四
period	"periodic,periodical"	四
perish	""	六
permanent	"permanence"	四
permeate	"permeation"	六
permit	"permission,permissible,permissive"	四
perpetual	"perpetuate"	六
perplex	"perplexity"	六
persecute	"persecution"	六
persevere	"perseverance"	四
persist	"persistent,persistence"	四
person	"personal,personally,personality"	四
personnel	""	四
perspective	""	四
persuade	"persuasion,persuasive"	四
pessimism	"pessimistic,pessimist"	四
pest	""	六
pesticide	""	六
pet	""	四
petition	"petitioner"	六
petrochemical	""	六
petrol	""	四
petroleum	""	四
petty	""	四
pharmacy	"pharmaceutical"	六
phase	""	四
phenomenon	""	四
philosophy	"philosophical,philosopher"	四
photo(graph)	"photographic,photographer,photography"	四
phrase	"phrasal"	四
physical	""	四
physician	""	四
physics	"physicist"	四
physiological	""	六
piano	"pianist"	四
pick	"picky"	四
picnic	""	四
picture	"picturesque"	四
pie	""	四
piece	""	四
pierce	""	四
pig	""	四
pigeon	""	四
pile	""	四
pilgrim	"pilgrimage"	六
pill	""	四
pillar	""	四
pillow	""	四
pilot	""	四
pin	""	四
pinch	""	四
pine	""	四
pink	""	四
pint	""	四
pioneer	""	四
pipe	""	四
pirate	"piracy"	四
pistol	""	四
pit	""	四
pitch	""	四
pity	""	四
pizza	""	四
place	"placement"	四
plague	""	四
plain	""	四
plaintiff	""	六
plan	"planning,planner"	四
plane	""	四
planet	"planetary"	四
plant	"plantation"	四
plastic	""	四
plate	""	四
plateau	""	六
platform	""	四
plausible	""	六
play	"player"	四
playground	""	四
plaza	""	六
plea	""	六
plead	""	六
please	"pleasure,pleasant,pleasing"	四
pledge	""	四
plenty	"plentiful"	四
plight	""	六
plot	""	四
plow/plough	""	四
plug	""	四
plumber	""	六
plumbing	""	六
plunge	""	四
plural	""	四
plus	""	四
pocket	""	四
podcast	""	四
poem	"poetry"	四
poet	"poetic"	四
point	"pointless"	四
poise	"poised"	六
poison	"poisonous"	四
poke	""	六
pole	"polar"	四
police	"policeman"	四
policy	""	四
polish	""	四
polite	"politeness"	四
politics	"political,politician"	四
pol	"pollster"	四
pollute	"pollution,pollutant"	四
polytechnic	""	六
pond	""	四
ponder	""	六
pool	""	四
poor	"poverty"	四
pop	""	四
popular	"popularity"	四
population	"populous,populate"	四
porcelain	""	六
porch	""	六
pork	""	四
porridge	""	六
port	"portable,porter"	四
portfolio	""	六
portion	""	四
portray	"portrayal,portrait"	六
pose	"posture"	四
position	""	四
positive	""	四
possess	"possession,possessive"	四
possible	"possibility,possibly"	四
post1	"postage,postman"	四
post2	""	四
postcard	""	四
poster	""	四
postpone	"postponement"	四
pot	""	四
potato	""	四
potent	""	六
potential	"potentiality"	四
pottery	""	六
poultry	""	六
pound1	""	四
pound2	""	四
pour	""	四
powder	""	四
power	"powerful"	四
practice/-ise	"practicable"	四
practical	"practicality"	四
practitioner	""	六
praise	""	四
pray	"prayer1,prayer2"	四
preach	"preacher"	四
precaution	"precautionary"	四
precede	"preceding,precedent"	六
precious	""	四
precise	"precision,precisely"	四
predator	"predatory"	六
predecessor	""	六
predict	"prediction,predictable"	四
predominate	"predominance,predominant"	六
preface	""	四
prefer	"preferable,preference,preferential"	四
pregnant	"pregnancy"	四
prejudice	""	四
preliminary	""	四
premature	""	六
premier	""	四
premise	""	六
premium	""	六
preoccupy	"preoccupied"	六
prepare	"preparation,preparatory"	四
preposition	""	四
prerequisite	""	六
prescribe	"prescription"	四
present1	"presence"	四
present2	"presentation"	四
present3	"presently"	四
preserve	"preservation,preservative"	四
preside	""	六
president	"presidency,presidential"	四
press1	""	四
press2	"pressure,pressing"	四
prestige	"prestigious"	六
presume	"presumption,presumably"	六
pretend	"pretense/-ce"	四
pretext	""	六
pretty	""	四
prevail	"prevalence,prevalent"	四
prevent	"prevention,preventive"	四
preview	""	四
previous	""	四
prey	""	六
price	"priceless"	四
pride	"proud"	四
priest	""	四
primary	"primarily"	四
prime	""	四
primitive	""	四
prince/princess	""	四
principal	""	四
principle	""	四
print	"printer,printing"	四
prior	"priority"	四
prison	"prisoner"	四
private	"privacy,privatize/-ise,privatization/-sation"	四
privilege	"privileged"	四
prize	""	四
probable	"probability,probably"	四
probe	""	六
problem	"problematic"	四
procedure	""	四
proceed	"proceedings"	四
process	"processor"	四
procession	""	四
proclaim	"proclamation"	四
produce	"production,productive,productivity"	四
product	""	四
profession	"professional"	四
professor	""	四
proficient	"proficiency"	四
profile	""	六
profit	"profitable"	四
profound	""	四
program(me)	""	四
progress	"progressive,progression"	四
prohibit	"prohibition,prohibitive"	四
project1	""	四
project2	"projector,projection"	四
prolong	""	六
prominent	"prominence"	四
promise	"promising"	四
promote	"promotion"	四
prompt	""	四
prone	""	六
pronoun	""	四
pronounce	"pronunciation"	四
proof	""	四
proofread	""	六
prop	""	六
propaganda	""	六
propagate	"propagation"	六
propel	"propeller"	六
proper	""	四
property	""	四
proportion	"proportional"	四
propose	"proposal,proposition"	四
prose	""	四
prosecute	"prosecution"	六
prospect	"prospective"	四
prosper	"prosperity,prosperous"	六
protect	"protection,protective"	四
protein	""	四
protest	""	四
protocol	""	六
prototype	""	六
prove	""	四
proverb	"proverbial"	四
provide	"provision"	四
provided	""	四
province	"provincial"	四
provoke	"provocation,provocative"	四
proximate	"proximity"	六
psychiatry	"psychiatric,psychiatrist"	六
psychology	"psychological,psychologist"	四
pub	""	四
public	"publicize/-ise,publicity,publicly"	四
publish	"publication"	四
pudding	""	六
pull	""	四
pulse	""	四
pump	""	四
pumpkin	""	六
punch	""	四
punctual	"punctuality"	四
punish	"punishment"	四
pupil	""	四
purchase	""	四
pure	"purity,purify"	四
purple	""	四
purpose	"purposeful"	四
purse	""	四
pursue	"pursuit"	四
push	"pushy"	四
put	""	四
puzzle	"puzzlement"	四
pyramid	""	六
quake	""	四
qualify	"qualification"	四
quality	"qualitative"	四
quantify	"quantification"	四
quantity	"quantitative"	四
quarrel	"quarrelsome"	四
quart	""	六
quarter	"quarterly"	四
queen	""	四
query	""	六
quest	""	六
question	"questionnaire"	四
queue	""	四
quick	""	四
quiet	""	四
quit	""	四
quite	""	四
quiver	""	六
quiz	""	四
quota	""	四
quote	"quotation"	四
rabbit	""	四
race1	"racial,racism,racist"	四
race2	""	四
rack	""	四
radar	""	四
radiate	"radiation,radiator,radiant"	六
radical	""	四
radio	""	四
radioactive	"radioactivity"	六
rag	"ragged,raggedly"	四
rage	"raging"	四
raid	""	四
rail	""	四
railroad/railway	""	四
rain	"rainy"	四
rainbow	""	四
raincoat	""	四
raise	""	四
rally	""	四
ranch	""	六
random	""	六
range	""	四
rank	""	四
rap	""	六
rape	""	六
rapid	"rapidity"	四
rare	"rarely,rarity"	四
rash	""	六
rat	""	四
rate	"rating"	四
rather	""	四
ratify	"ratification"	六
ratio	""	四
ration	""	六
rational	""	四
rattle	""	六
raw	""	四
ray	""	四
reach	""	四
react	"reaction,reactionary"	四
read	"reading,reader"	四
ready	"readily"	四
real	"really,reality"	四
realistic	"realism"	四
realize/-ise	"realization/-sation"	四
realm	""	四
reap	""	四
rear	""	四
reason	"reasonable"	四
reassure	"reassurance"	六
rebel	"rebellion,rebellious"	四
recall	""	四
recede	""	六
receive	"receipt,recipient,receptive,receiver"	四
recent	"recently"	四
reception	"receptionist"	四
recession	""	四
recipe	""	六
reciprocal	""	六
recite	"recitation"	四
reckless	""	六
reckon	""	四
recognize/-ise	"recognition"	四
recommend	"recommendation"	四
reconcile	"reconciliation,reconciliatory"	六
record	"recorder,recording"	四
recover	"recovery"	四
recreation	"recreational"	四
recruit	"recruitment"	四
rectify	"rectification"	六
recur	"recurrence"	六
recycle	"recyclable"	四
red	""	四
reduce	"reduction"	四
redundant	"redundancy"	六
reel	""	六
refer	"reference"	四
referee	""	六
referendum	""	六
refine	"refinery,refinement"	四
reflect	"reflection/-xion,reflective"	四
reform	"reformation,reformist"	四
refrain	""	四
refresh	""	四
refreshment	""	四
refrigerator/fridge	"refrigeration"	四
refuge	"refugee"	六
refund	""	六
refuse	"refusal"	四
refute	"refutation"	六
regard	""	四
regarding	""	四
regardless	""	四
regime	""	六
regiment	"regimental"	六
region	"regional"	四
register	"registration,registrar"	四
regret	"regrettable,regretful"	四
regular	"regularity"	四
regulate	"regulation,regulatory,regulator"	四
rehabilitate	"rehabilitation"	六
rehearse	"rehearsal"	六
reign	""	六
rein	""	六
reinforce	"reinforcement"	四
reject	"rejection"	四
rejoice	"rejoicing"	六
relate	"relation,relationship"	四
relative	"relativity"	四
relax	"relaxation"	四
relay	""	四
release	""	四
relentless	""	六
relevant	"relevance"	四
relic	""	六
relieve	"relief"	四
religion	"religious"	四
relish	""	六
reluctant	"reluctance"	四
rely	"reliance,reliable"	四
remain	"remainder"	四
remark	"remarkable"	四
remedy	"remedial"	四
remember	"remembrance"	四
remind	"reminder"	四
reminiscent	"reminiscence"	六
remnant	""	六
remote	""	四
remove	"removal"	四
renaissance	""	六
render	"rendering"	四
renew	"renewal,renewable"	四
renovate	"renovation"	四
renown	"renowned"	六
rent	"rental"	四
repair	"reparable"	四
repay	"repayment"	四
repeat	"repetition,repetitive,repeatedly"	四
repel	""	六
repertoire	""	六
replace	"replacement"	四
reply	""	四
report	"reporter"	四
represent	"representation,representative"	四
repress	"repression,repressive"	六
reproach	""	六
reproduce	"reproduction,reproductive"	四
republic	"republican"	四
reputation	""	四
repute	"reputable"	六
request	""	四
require	"requirement"	四
rescue	""	四
research	"researcher"	四
resemble	"resemblance"	四
resent	"resentment"	四
reserve	"reservation,reserved"	四
reservoir	""	六
reshuffle	""	六
reside	"residence,resident,residential"	四
resign	"resignation"	四
resist	"resistance,resistant"	四
resolve	"resolution,resolute"	四
resort1	""	四
resort2	""	四
resource	"resourceful"	四
respect	"respectable,respectful"	四
respective	"respectively"	四
respond	"response,responsive,respondent"	四
responsible	"responsibility"	四
rest1	""	四
rest2	""	四
restaurant	""	四
restless	""	六
restore	"restoration"	四
restrain	"restraint"	四
restrict	"restriction,restrictive"	四
result	"resultant"	四
resume1	"resumption"	四
résumé2	""	四
retail	"retailer"	四
retain	"retention"	四
retaliate	"retaliation"	六
retarded	""	六
retell	"retelling"	四
retire	"retirement,retired"	四
retort	""	六
retreat	""	四
retrieve	"retrieval"	六
retrospect	"retrospective"	六
return	""	四
reunite	"reunification,reunion"	四
reveal	"revelation"	四
revenge	"revengeful"	六
revenue	""	四
reverse	"reversal,reversible"	四
review	"reviewer"	四
revise	"revision"	四
revive	"revival"	六
revolt	""	六
revolution	"revolutionary"	四
revolve	""	四
reward	"rewarding"	四
rhetoric	"rhetorical"	六
rhythm	"rhythmic"	四
rib	""	四
ribbon	""	四
rice	""	四
rich	""	四
rid	""	四
riddle	""	四
ride	"rider"	四
ridge	""	六
ridicule	"ridiculous"	四
rifle	""	四
rig	""	六
right	""	四
rigid	"rigidity"	六
rigo(u)r	"rigorous"	六
rim	""	六
ring	""	四
riot	"riotous"	四
rip	""	四
ripe	"ripen"	四
rise	""	四
risk	"risky"	四
ritual	""	六
rival	"rivalry"	四
river	""	四
road	""	四
roar	""	四
roast	""	四
rob	"robbery"	四
robot	"robotic"	四
robust	""	六
rock	"rocky"	四
rocket	""	四
rod	""	四
role	""	四
roll	"roller"	四
romance	"romantic"	四
roof	""	四
room	""	四
root	""	四
rope	""	四
rose	"rosy"	四
rot	"rotten"	六
rotate	"rotation"	六
rough	"roughly"	四
round	""	四
rouse	""	四
route	""	四
routine	""	四
row1	""	四
row2	""	四
royal	"royalty"	四
rub	""	四
rubber	""	四
rubbish	""	四
rude	""	四
rug	""	四
ruin	"ruinous"	四
rule	"ruler,ruling"	四
rumo(u)r	""	四
run	"runner,running"	四
runway	""	四
rural	""	四
rush	""	四
rust	"rusty"	六
ruthless	""	六
sack	""	四
sacred	""	六
sacrifice	"sacrificial"	四
sad	"sadness,sadden"	四
saddle	""	六
safe	"safety"	四
safeguard	""	六
sail	"sailing,sailor"	四
saint	""	四
sake	""	四
salad	""	四
salary	""	四
sale	""	四
salesman	""	四
salmon	""	六
salon	""	六
salt	"salty"	四
salute	"salutation"	六
salvage	""	六
salvation	""	六
same	""	四
sample	""	四
sanction	""	六
sanctuary	""	六
sand	""	四
sandwich	""	四
sanitation	"sanitary"	六
sarcasm	"sarcastic"	六
satellite	""	四
satire	"satirical,satirist"	六
satisfy	"satisfaction,satisfactory"	四
saturate	"saturation"	六
Saturday	""	四
sauce	""	四
sausage	""	四
savage	""	六
save	"saving"	四
say	"saying"	四
scale	""	四
scan	"scanner"	四
scandal	"scandalous"	四
scar	""	四
scarce	"scarcity,scarcely"	四
scare	"scary"	四
scatter	""	四
scenario	""	六
scene	"scenery,scenic"	四
scent	""	四
schedule	""	四
scheme	""	四
scholar	"scholarly,scholarship,scholastic"	四
school	"schooling"	四
science	"scientific,scientist"	四
scissors	""	四
scold	""	四
scope	""	四
score	""	四
scorn	"scornful"	六
scout	""	四
scramble	""	六
scrap	""	六
scrape	""	六
scratch	""	四
scream	""	四
screen	""	四
screw	""	四
script	"scripture"	四
scrub	""	六
scrutiny	"scrutinize/-ise"	六
sculpture	""	六
sea	""	四
seal	""	四
search	""	四
season	"seasonal"	四
seat	""	四
second1	""	四
second2	""	四
secondary	""	四
second-hand	""	四
secret	"secrecy,secretive"	四
secretary	"secretarial"	四
section	""	四
sector	""	四
secular	""	六
secure	"security"	四
seduce	"seduction,seductive"	六
see	""	四
seed	"seedling"	四
seek	""	四
seem	"seeming,seemingly"	四
segment	"segmental"	四
segregate	"segregation"	六
seize	"seizure"	四
seldom	""	四
select	"selection,selective"	四
self	"selfish,selfless"	四
sell	""	四
semester	""	四
seminar	""	四
senate	"senator"	四
send	""	四
senior	"seniority"	四
sensation	"sensational"	六
sense	"sensible,sensor"	四
sensitive	"sensitivity"	四
sentence	""	四
sentiment	"sentimental"	六
separate	"separation,separatist"	四
September	""	四
sequence	"sequential"	四
sergeant	""	六
serial	""	六
series	""	四
serious	""	四
servant	""	四
serve	"service,serving"	四
session	""	四
set	""	四
setback	""	四
setting	""	四
settle	"settlement"	四
seven	""	四
seventeen	""	四
seventy	""	四
several	""	四
severe	"severity"	四
sew	""	四
sex	"sexy,sexual"	四
shabby	""	六
shade	"shady"	四
shadow	""	四
shaft	""	六
shake	"shaky"	四
shall	""	四
shallow	""	四
shame	"shameful,shameless"	四
shape	""	四
share	""	四
shark	""	六
sharp	"sharpen"	四
shatter	""	六
shave	"shaver"	四
she	""	四
shed	""	四
sheep	""	四
sheer	""	四
sheet	""	四
shelf	""	四
shell	""	四
shelter	""	四
shepherd	""	六
shield	""	六
shift	""	四
shine	"shiny"	四
ship	"shipping,shipment"	四
shipyard	""	六
shirt	""	四
shit	""	四
shiver	""	四
shock	""	四
shoe	""	四
shoot	""	四
shop	"shopping"	四
shore	""	四
short	"shortage,shorts"	四
shortcoming	""	四
shorthand	""	六
shortly	""	四
shot	""	四
should	""	四
shoulder	""	四
shout	""	四
shove	""	六
show	"showy"	四
showcase	""	六
shower	""	四
shred	""	六
shrewd	""	六
shrimp	""	四
shrink	""	四
shrub	"shrubbery"	六
shrug	""	四
shut	""	四
shuttle	""	四
shy	"shyness,shyly"	四
sick	"sicken"	四
side	""	四
sideways	""	四
siege	""	四
sigh	""	四
sight	""	四
sightseeing	""	四
sign	"signature"	四
signal	""	四
significant	"significance"	四
signify	""	六
silent	"silence"	四
silicon	""	四
silk	"silky"	四
silver	"silvery"	四
similar	"similarity"	四
simple	"simplicity,simplify,simply"	四
simulate	"simulation"	六
simultaneous	""	六
sin	""	四
since	""	四
sincere	"sincerity"	四
sing	"singer"	四
single	""	四
singular	"singularity"	四
sinister	""	六
sink	""	四
sip	""	四
sir	""	四
sister	""	四
sit	"sitting"	四
site	""	四
situation	""	四
situate	""	四
six	""	四
sixteen	""	四
sixty	""	四
size	"sizable"	四
skate	"skating"	四
skeleton	""	四
skeptical/sceptical	"skeptic/sceptic,skepticism/scepticism"	六
sketch	"sketchy"	四
ski	"skiing"	四
skill	"skil(l)ful,skilled"	四
skim	""	六
skin	"skinny"	四
skip	""	四
skirt	""	四
skull	""	六
sky	""	四
skyline	""	四
skyscraper	""	四
slack	""	六
slam	""	六
slap	""	四
slash	""	六
slaughter	""	六
slave	"slavery"	四
sleep	"sleepy,sleepiness"	四
sleeve	""	四
slender	""	四
slice	""	四
slide	""	四
slight	"slightly"	四
slim	""	四
slip	"slippery,slipper"	四
slogan	""	四
slope	""	四
slot	""	六
slow	""	四
slum	""	六
slump	""	六
small	""	四
smart	""	四
smartphone	""	四
smash	""	四
smell	"smelly"	四
smile	""	四
smog	"smoggy"	四
smoke	"smoky"	四
smooth	""	四
smuggle	"smuggling,smuggler"	六
snack	""	四
snail	""	六
snake	""	四
snap	""	六
snatch	""	六
sneak	""	六
sniff	""	六
snob	"snobbish"	六
snow	"snowy"	四
so	""	四
soak	""	四
soap	""	四
soar	""	四
sob	""	六
sober/-re	""	六
so-called	""	四
soccer	""	四
society	"social,socialize/-ise,sociable"	四
socialism	"socialist"	四
sociology	"sociologist"	四
sock	""	四
socket	""	六
soda	""	四
sodium	""	六
sofa	""	四
soft	"soften"	四
software	""	四
soil	""	四
solar	""	四
soldier	""	四
sole	"solely"	四
solemn	"solemnity"	四
solicit	"solicitor"	六
solid	"solidity,solidify"	四
solidarity	""	六
solitary	"solitude"	六
solo	""	六
solve	"solution,solvent,soluble"	四
some	""	四
somebody	""	四
somehow	""	四
someone	""	四
something	""	四
sometime	""	四
sometimes	""	四
somewhat	""	四
somewhere	""	四
son	""	四
song	""	四
soon	""	四
soothe	""	六
sophisticated	"sophistication"	四
sore	""	四
sorrow	"sorrowful"	四
sorry	""	四
sort	""	四
soul	""	四
sound1	""	四
sound2	""	四
soup	""	四
sour	""	四
source	""	四
south	"southern"	四
southeast	"southeastern"	四
southwest	"southwestern"	四
souvenir	""	四
sovereign	"sovereignty"	六
sow	""	四
space	"spacious,spatial"	四
spaceship/spacecraft	""	四
spade	""	四
spaghetti	""	六
span	""	四
spare	"sparingly"	四
spark	""	四
sparkle	""	四
speak	"speaker"	四
spear	""	六
special	"specialize/-ise,specialization/-sation,specialist"	四
specialty/speciality	""	六
species	""	四
specific	"specifically"	四
specify	"specification"	四
specimen	""	四
spectacle	"spectacular"	六
spectator	""	六
spectrum	""	六
speculate	"speculation,speculative"	四
speech	"speechless"	四
speed	"speedy,speeding"	四
spell	"spelling"	四
spend	"spending"	四
sphere	"spherical"	四
spice	"spicy"	六
spider	""	六
spill	""	四
spin	""	四
spine	"spinal"	六
spiral	""	六
spirit	"spiritual"	四
spit	""	四
spite	""	四
splash	""	四
splendid	"splendo(u)r"	四
split	""	四
spoil	""	四
spokesman/spokeswoman	"spokesperson"	四
sponge	"spongy"	六
sponsor	"sponsorship"	四
spontaneous	"spontaneity"	四
spoon	"spoonful"	四
sport	""	四
sportsman/sportswoman	""	四
spot	""	四
spotlight	""	六
spouse	""	四
sprawl	""	六
spray	""	四
spread	""	四
spring	""	四
sprinkle	""	六
spur	""	四
spy	""	四
squad	""	六
square	""	四
squeeze	""	四
stab	""	六
stable	"stability,stabilize/-ise"	四
stack	""	四
stadium	""	四
staff	""	四
stage	""	四
stagger	""	六
stagnate	"stagnation,stagnant"	六
stain	"stainless"	四
stair	""	四
staircase	""	四
stake	""	四
stale	""	四
stalk	""	六
stall	""	六
stammer	""	六
stamp1	""	四
stamp2	""	四
stance	""	六
stand	""	四
standard	"standardize/-ise,standardization/-sation"	四
standby	""	六
standpoint	""	四
staple1	""	四
staple2	"stapler"	六
star	"starry"	四
stare	""	四
stark	""	六
start	"starter"	四
startle	""	四
starve	"starvation"	四
state	"statement"	四
statesman	""	四
static	""	六
station	"stationary"	四
stationery	""	六
statistic	"statistical"	四
statue	""	四
status	""	四
statute	"statutory"	六
stay	""	四
steady	"steadily"	四
steak	""	四
steal	""	四
steam	"steamy,steamer"	四
steel	""	四
steep	""	四
steer	""	四
stem1	""	四
stem2	""	四
step	""	四
stereotype	""	六
stern	""	六
steward(ess)	""	六
stick1	""	四
stick2	"sticky"	四
stiff	"stiffen"	四
stifle	""	六
stigma	""	六
still1	""	四
still2	""	四
stimulate	"stimulation,stimulus,stimulant"	四
sting	""	四
stipulate	"stipulation"	六
stir	""	四
stitch	""	六
stock	""	四
stocking	""	四
stomach	""	四
stone	"stony"	四
stool	""	四
stoop	""	六
stop	"stoppage"	四
store1	""	四
store2	"storage"	四
storm	"stormy"	四
story1	""	四
stor(e)y2	""	四
stout	""	六
stove	""	四
straight	"straighten"	四
straightforward	""	四
strain1	""	四
strain2	""	四
strait	""	六
strand	""	六
strange	"stranger"	四
strangle	""	六
strap	""	四
strategy	"strategic"	四
straw	""	四
stray	""	六
streak	""	六
stream	""	四
streamline	""	六
street	""	四
stress	"stressful"	四
stretch	""	四
strict	""	四
stride	""	四
strike	"striking"	四
string	""	四
strip	""	四
stripe	""	四
strive	""	四
stroke1	""	四
stroke2	""	四
stroll	""	六
strong	"strength,strengthen"	四
structure	"structural"	四
struggle	""	四
stubborn	""	六
student	""	四
studio	""	四
study	""	四
stuff	"stuffy,stuffing"	四
stumble	""	六
stump	""	六
stun	"stunning"	六
stupid	"stupidity"	四
sturdy	""	六
style	"stylish"	四
subject1	""	四
subject2	""	四
subjective	""	四
submarine	""	六
submerge	""	六
submit	"submission,submissive"	四
subordinate	"subordination"	六
subscribe	"subscription,subscriber"	六
subsequent	""	四
subsidy	"subsidize/-ise"	六
subsistence	""	六
substance	"substantial"	四
substitute	"substitution"	四
subtle	"subtlety"	六
subtract	"subtraction"	四
suburb	"suburban"	四
subway	""	四
succeed	"successor,succession,successive"	四
success	"successful"	四
such	""	四
suck	""	四
sudden	"suddenly"	四
sue	""	六
suffer	"suffering"	四
suffice	""	六
sufficient	""	四
sugar	""	四
suggest	"suggestion,suggestive"	四
suicide	"suicidal"	六
suit1	"suitable"	四
suit2	""	四
suitcase	""	四
suite	""	六
sulfur/sulphur	""	六
sum	""	四
summary	"summarize/-ise"	四
summer	""	四
summit	""	四
summon	""	六
sun	"sunny"	四
Sunday	""	四
sunlight	""	四
sunrise	""	四
sunset	""	四
sunshine	""	四
super	""	四
superb	""	四
superficial	""	四
superintendent	""	六
superior	"superiority"	四
supermarket	""	四
superstition	"superstitious"	六
supervise	"supervision,supervisor"	四
supper	""	四
supplement	"supplementary"	四
supply	"supplier"	四
support	"supportive,supporter"	四
suppose	"supposition,supposedly"	四
suppress	"suppression,suppressive"	六
supreme	"supremacy"	四
sure	""	四
surf	"surfing"	四
surface	""	四
surge	""	四
surgery	"surgical,surgeon"	四
surname	""	四
surpass	""	六
surplus	""	四
surprise	""	四
surrender	""	四
surround	"surroundings"	四
surveillance	""	六
survey	""	四
survive	"survival,survivor"	四
susceptible	""	六
suspect	""	四
suspend	"suspension,suspense"	四
suspicion	"suspicious"	四
sustain	"sustainable,sustainability"	四
swallow1	""	四
swallow2	""	四
swamp	""	六
swap	""	六
sway	""	四
swear	""	四
sweat	"sweater"	四
sweep	""	四
sweet	""	四
swell	""	四
swift	""	四
swim	"swimming,swimmer"	四
swing	""	四
swipe	""	四
switch	""	四
sword	""	四
symbol	"symbolic(al)"	四
symmetry	"symmetric(al)"	六
sympathy	"sympathetic,sympathize/-ise"	四
symphony	""	六
symposium	""	六
symptom	""	四
syndicate	""	六
syndrome	""	六
synonym	""	六
synthesis	"synthetic,synthesize/-ise"	六
system	"systematic,systematically"	四
table	""	四
tablet	""	四
taboo	""	六
tack	""	六
tackle	""	四
tact	"tactful"	六
tactic	""	六
tag	""	四
tail	""	四
tailor	""	四
take	""	四
takeoff	""	四
tale	""	四
talent	"talented"	四
talk	"talkative"	四
tall	""	四
tame	""	四
tan	""	六
tangible	""	四
tangle	""	六
tank	""	四
tanker	""	六
tap	""	四
tape	""	四
target	""	四
tariff	""	六
task	""	四
taste	"tasty"	四
tax	"taxation"	四
taxi	""	四
tea	""	四
teach	"teacher,teaching"	四
team	""	四
tear1	""	四
tear2	""	四
tease	""	六
technical	"technician"	四
technique	""	四
technology/tech	"technological"	四
tedious	""	四
teen	""	四
teenager	""	四
telecommunications	""	四
telephone/phone	""	四
telescope	"telescopic"	四
television/TV	""	四
tell	"telling"	四
teller	""	四
temper	""	四
temperament	""	六
temperature	""	四
temple	""	四
tempo	""	六
temporal	""	六
temporary	"temporarily"	四
tempt	"temptation"	六
ten	""	四
tenant	""	六
tend	"tendency"	四
tender	""	四
tennis	""	四
tense1	"tension"	四
tense2	""	四
tent	""	四
tentative	""	六
tenure	""	六
term	""	四
terminal	""	四
terminate	"termination"	六
terrace	""	六
terrain	""	六
terrible	"terribly"	四
terrific	""	四
territory	"territorial"	四
terror	"terrify,terrorism,terrorist"	四
tertiary	""	六
test	""	四
testify	""	六
testimony	""	六
text	""	四
textbook	""	四
textile	""	四
texture	""	六
than	""	四
thank	"thankful"	四
Thanksgiving	""	四
that	""	四
the	""	四
theater/-tre	"theatrical"	四
theft	""	四
their	""	四
theirs	""	四
them	""	四
theme	""	四
themselves	""	四
then	""	四
theory	"theoretical"	四
therapy	"therapist,therapeutic(al)"	四
there	""	四
thereby	""	四
therefore	""	四
thermal	""	六
thermometer	""	四
these	""	四
thesis	""	四
they	""	四
thick	""	四
thief	""	四
thigh	""	六
thin	""	四
thing	""	四
think	"thinking"	四
third	""	四
thirst	"thirsty"	四
thirteen	""	四
thirty	""	四
this	""	四
thorn	"thorny"	六
thorough	""	四
those	""	四
though	""	四
thought	"thoughtful"	四
thousand	""	四
thread	""	四
threat	"threaten"	四
three	""	四
threshold	""	六
thrift	"thrifty"	六
thrill	"thriller"	六
thrive	""	四
throat	""	四
throne	""	六
through	""	四
throughout	""	四
throw	""	四
thrust	""	四
thumb	""	四
thunder	"thunderous"	四
Thursday	""	四
thus	""	四
tick	""	四
ticket	""	四
tickle	""	六
tide	"tidal"	四
tidy	""	四
tie	""	四
tiger	"tigress"	四
tight	"tighten"	四
tile	""	六
till	""	四
tilt	""	六
timber	""	四
time	"timely,timing"	四
timid	""	六
tin	""	四
tiny	""	四
tip	""	四
tire	"tired,tiring,tireless,tiresome"	四
tissue	""	四
title	""	四
to	""	四
toast	""	四
tobacco	""	四
today	""	四
toe	""	四
together	""	四
toil	""	六
toilet	""	四
token	""	四
tolerate	"tolerance,tolerant,tolerable"	四
toll	""	四
tomato	""	四
tomorrow	""	四
ton	"tonnage"	四
tone	""	四
tongue	""	四
tonight	""	四
too	""	四
tool	""	四
tooth	""	四
top	""	四
topic	"topical"	四
topple	""	六
torch	""	四
tornado	""	六
torture	""	四
toss	""	四
total	""	四
touch	""	四
tough	""	四
tour	"tourism,tourist"	四
tournament	""	六
tow	""	六
toward(s)	""	四
towel	""	四
tower	""	四
town	"township"	四
toxic	""	六
toy	""	四
trace	""	四
track	""	四
tract	""	六
tractor	""	四
trade	""	四
trademark	""	四
tradition	"traditional"	四
traffic	"trafficking"	四
tragedy	"tragic,tragically"	四
trail	"trailer"	四
train	"trainer,trainee,training"	四
trait	""	六
tram	""	四
tranquil	"tranquility"	六
transaction	""	四
transcend	""	六
transcript	""	四
transfer	"transference"	四
transform	"transformation"	四
transient	""	六
transistor	""	六
transit	""	四
transition	"transitional"	六
translate	"translation,translator"	四
transmit	"transmission,transmitter"	四
transparent	"transparency"	四
transplant	"transplantation"	四
transport	"transportation"	四
trap	""	四
trash	""	四
trauma	"traumatic"	六
travel	""	四
tray	""	四
tread	""	六
treasure	""	四
treasury	"treasurer"	六
treat	"treatment"	四
treaty	""	四
tree	""	四
trek	""	六
tremble	""	四
tremendous	""	四
trench	""	六
trend	""	四
trial	""	四
triangle	"triangular"	四
tribe	"tribal"	六
tribune	""	六
tribute	""	六
trick	"tricky"	四
trickle	""	六
trifle	""	四
trigger	""	四
trillion	""	六
trim	""	六
trip	""	四
triple	""	四
triumph	"triumphant"	四
trivial	""	六
trolley/trolly	""	四
troop	""	四
trophy	""	六
tropic	"tropical"	六
trouble	"troublesome"	四
trousers	""	四
truck	""	四
true	"truly"	四
trumpet	""	六
trunk	""	四
trust	"trustee"	四
truth	"truthful"	四
try	"trial,trying"	四
tub	""	六
tube	""	四
tuck	""	六
Tuesday	""	四
tug	""	六
tuition	""	四
tumble	""	六
tumo(u)r	""	四
tune	""	四
tunnel	""	四
turbulent	"turbulence"	六
turkey	""	四
turmoil	""	六
turn	""	四
turnout	""	六
turnover	""	六
turtle	""	六
tutor	"tutorial"	四
twelve	"twelfth"	四
twenty	"twentieth"	四
twice	""	四
twin	""	四
twist	""	四
two	""	四
type	"typist"	四
typewriter	""	四
typical	""	四
tyre/tire	""	四
ugly	"ugliness"	四
ultimate	"ultimately"	四
ultra	""	六
umbrella	""	四
unanimous	""	六
uncertain	"uncertainty"	四
uncle	""	四
uncover	""	四
under	""	四
underdeveloped	""	四
underestimate	""	四
undergo	""	四
undergraduate	""	四
underground	""	四
underlie	"underlying"	六
underline	""	四
undermine	""	四
underneath	""	四
understand	"understanding"	四
undertake	"undertaking"	四
underwear	""	四
undo	""	四
undoubtedly	""	四
uneasy	""	四
unemployed	"unemployment"	四
unfold	""	六
uniform	"uniformity"	四
unify	"unification"	六
unilateral	""	六
union	""	四
unique	""	四
unit	""	四
unite	"unity"	四
universe	"universal"	四
university	""	四
unleash	""	六
unless	""	四
unprecedented	""	六
until	""	四
unveil	""	六
up	""	四
update	""	四
upgrade	""	四
uphold	""	六
upload	""	四
upon	""	四
upper	""	四
upright	""	四
uprising	""	六
upset	""	四
upstairs	""	四
up-to-date	""	四
upward	"upwards"	四
uranium	""	六
urban	"urbanize/-ise,urbanization/-sation"	四
urge	""	四
urgent	"urgency"	四
urine	"urinate"	六
us	""	四
usage	""	四
use	"user,useful,useless"	四
used	""	四
usual	"usually"	四
utility	""	四
utilize/-ise	"utilization/-sation"	四
utmost	""	四
utter1	""	四
utter2	"utterly"	四
vacant	"vacancy"	四
vacation	""	四
vaccine	"vaccinate,vaccination"	六
vacuum	""	四
vague	""	四
vain	"vanity"	四
valid	"validate,validity"	四
valley	""	四
value	"valuable"	四
valve	""	六
van	""	四
vanish	""	四
vapo(u)r	""	四
various	"variety"	四
vary	"variation,variable,variant"	四
vast	""	四
vegetable	"vegetarian"	四
vegetation	""	六
vehicle	""	四
veil	""	四
vein	""	六
velocity	""	六
velvet	""	六
vendor	""	四
vent	""	六
ventilate	"ventilation"	六
venture	""	四
venue	""	六
verb	"verbal"	四
verdict	""	六
verge	""	六
verify	"verification"	四
versatile	""	六
verse	""	六
version	""	四
versus	""	四
vertical	""	四
very	""	四
vessel	""	四
vest	""	六
veteran	""	四
veto	""	四
via	""	四
viable	""	六
vibrate	"vibration"	六
vice	""	六
vicinity	""	六
vicious	""	六
victim	"victimize"	四
victory	"victorious"	四
video	""	四
view	""	四
viewpoint	""	四
vigor	"vigorous"	四
village	"villager"	四
vinegar	""	四
violate	"violation"	四
violent	"violence"	四
violin	"violinist"	四
virgin	"virginity"	六
virtual	"virtually"	四
virtue	"virtuous"	四
virus	""	四
visa	""	四
visible	"visibility"	四
vision	"visionary"	四
visit	"visitor"	四
visual	"visualize/-ise"	四
vital	"vitality"	四
vitamin	""	四
vivid	""	四
vocabulary	""	四
vocal	""	六
vocation	"vocational"	四
vogue	""	六
voice	""	四
void	""	六
volatile	"volatility"	六
volcano	"volcanic"	四
volleyball	""	四
volt	"voltage"	四
volume	"voluminous"	四
volunteer	"voluntary"	四
vote	"voter"	四
voucher	""	六
vow	""	六
voyage	""	四
vulgar	""	六
vulnerable	"vulnerability"	四
wage	""	四
wag(g)on	""	四
waist	""	四
wait	"waiter/waitress"	四
waive	"waiver"	六
wake	"waken"	四
walk	""	四
wall	""	四
wallet	""	四
wander	""	四
want	""	四
war	""	四
ward	""	四
wardrobe	""	六
ware	""	四
warehouse	""	四
warfare	""	四
warm	"warmth"	四
warn	"warning"	四
warrant	""	六
warranty	""	六
warrior	""	四
wary	""	四
wash	"washing"	四
waste	"wasteful"	四
watch	"watchful"	四
water	""	四
waterproof	""	四
watertight	""	四
watt	""	六
wave	"wavy"	四
wax	""	四
way	""	四
we	""	四
weak	"weaken,weakness"	四
wealth	"wealthy"	四
weapon	""	四
wear	""	四
weary	"weariness"	六
weather	""	四
weave	""	四
web	""	四
webcast	""	四
website	""	四
wed	"wedding"	四
wedge	""	六
Wednesday	""	四
weed	""	四
week	"weekly"	四
weekday	""	四
weekend	""	四
weep	""	四
weigh	"weight"	四
weird	""	四
welcome	""	四
welfare	""	四
well1	""	四
well2	""	四
well-being	""	四
well-known	""	四
well-off	""	四
west	"western,westerner"	四
wet	""	四
whale	""	四
wharf	""	六
what	"whatever,whatsoever"	四
wheat	""	四
wheel	""	四
when	"whenever"	四
where	"wherever"	四
whereabouts	""	六
whereas	""	四
whereby	""	六
whether	""	四
which	"whichever"	四
while/whilst	""	四
whip	""	四
whirl	""	六
whiskey/whisky	""	四
whisper	""	四
whistle	""	四
white	""	四
who	"whoever"	四
whole	"wholly"	四
wholesale	""	六
wholesome	""	六
whom	""	四
whose	""	四
why	""	四
wicked	""	六
wide	"width,widen"	四
widespread	""	四
widow	"widower"	四
wield	""	六
wife	""	四
wild	""	四
wilderness	""	四
wildlife	""	四
will	"willing,willingness"	四
willpower	""	四
win	"winner"	四
wind1	"windy"	四
wind2	""	四
window	""	四
wine	"winery"	四
wing	""	四
wink	""	六
winter	""	四
wipe	""	四
wire	"wireless"	四
wise	"wisdom"	四
wish	""	四
wit	"witty"	四
witch	""	六
with	""	四
withdraw	"withdrawal"	四
wither	""	六
withhold	""	六
within	""	四
without	""	四
withstand	""	四
witness	""	四
wolf	""	四
woman	""	四
wonder	"wonderful"	四
wood	"wooden"	四
wool	"wool(l)en"	四
word	"wording"	四
work	"worker"	四
workforce	""	四
workout	""	四
workshop	""	四
world	""	四
worldwide	""	四
worm	""	四
worry	"worried"	四
worse	""	四
worship	""	四
worst	""	四
worth	"worthless"	四
worthwhile	""	四
worthy	"worthiness"	四
would	""	四
wound	""	四
wrap	"wrapping"	四
wreck	"wreckage"	四
wrench	""	六
wrestle	"wrestling"	六
wretched	""	六
wrinkle	""	四
wrist	""	四
write	"writer,writing"	四
wrong	""	四
x-ray	""	四
yacht	""	六
yard	""	四
yawn	""	六
year	"yearly"	四
yearn	"yearning"	六
yell	""	四
yellow	""	四
yes	"yeah"	四
yesterday	""	四
yet	""	四
yield	""	四
yoga	""	四
yoghurt	""	四
you	""	四
young	""	四
youngster	""	四
your	""	四
yours	""	四
yourself	"yourselves"	四
youth	"youthful"	四
zeal	"zealous"	六
zero	""	四
zigzag	""	六
zip	"zipper"	六
zone	""	四
zoo	""	四
zoology	"zoological"	四
zoom	""	六