a/an	art	高
abandon	v	高
ability	n	高
able	a	高
abnormal	a	高
aboard	prep	高
abolish	v	高
abortion	n	高
about	ad&prep	高
above	prep,a&ad	高
abroad	ad	高
abrupt	a	高
absence	n	高
absent	a	高
absolute	a	高
absorb	v	高
abstract	a&n	高
absurd	a	高
abundant	a	高
abuse	v	高
academic	a&n	高
academy	n	高
accelerate	v	高
accent	n	高
accept	v	高
access	n&v	高
accessible	a	高
accident	n	高
accommodation	n	高
accompany	v	高
accomplish	v	高
account	n	高
accountant	n	高
accumulate	v	高
accuracy	n	高
accurate	a	高
accuse	v	高
accustomed	a	高
ache	v&n	高
achieve	v	高
achievement	n	高
acid	a	高
acknowledge	v	高
acquaintance	n	高
acquire	v	高
acquisition	n	高
acre	n	高
across	prep	高
act	n&v	高
action	n	高
active	a	高
activity	n	高
actor	n	高
actress	n	高
actual	a	高
acute	a	高
AD	abbr	高
ad/advertisement	n	高
adapt	v	高
adaptation	n	高
add	v	高
addicted	a	高
addition	n	高
address	n	高
adequate	a	高
adjust	v	高
adjustment	n	高
administration	n	高
admirable	a	高
admire	v	高
admission	n	高
admit	v	高
adolescence	n	高
adolescent	a&n	高
adopt	v	高
adore	v	高
adult	n	高
advance	v&n	高
advantage	n	高
adventure	n	高
advertise	v	高
advertisement	n	高
advice	n	高
advise	v	高
advocate	v	高
affair	n	高
affect	v	高
affection	n	高
afford	v	高
afraid	a	高
Africa	n	高
African	a&n	高
after	ad,prep&conj	高
afternoon	n	高
afterward(s)	ad	高
again	ad	高
against	prep	高
age	n	高
agency	n	高
agenda	n	高
agent	n	高
aggressive	a	高
ago	ad	高
agree	v	高
agreement	n	高
agricultural	a	高
agriculture	n	高
ahead	ad	高
aid	n&v	高
AIDS	n	高
aim	n&v	高
air	n	高
aircraft	n	高
airline	n	高
airmail	n	高
airplane	n	高
airport	n	高
airspace	n	高
alarm	n&v	高
album	n	高
alcohol	n	高
alcoholic	a&n	高
algebra	n	高
alike	ad	高
alive	a	高
all	ad,a&pron	高
allergic	a	高
alley	n	高
allocate	v	高
allow	v	高
allowance	n	高
almost	ad	高
alone	a	高
along	ad&prep	高
alongside	ad	高
aloud	ad	高
alphabet	n	高
already	ad	高
also	ad	高
alternative	a	高
although	conj	高
altitude	n	高
altogether	ad	高
aluminum/aluminium	n	高
always	ad	高
am	v(be)	高
a.m./am,A.M./AM	abbr	高
amateur	a	高
amaze	v	高
amazing	a	高
ambassador	n	高
ambassadress	n	高
ambiguous	a	高
ambition	n	高
ambulance	n	高
America	n	高
among	prep	高
amount	n&v	高
ample	a	高
amuse	v	高
amusement	n	高
analyze/-yse	v	高
analysis	n	高
ancestor	n	高
anchor	v&n	高
ancient	a	高
and	conj	高
anecdote	n	高
anger	n	高
angle	n	高
angry	a	高
animal	n	高
ankle	n	高
anniversary	n	高
announce	v	高
annoy	v	高
annual	a	高
another	a&pron	高
answer	n&v	高
ant	n	高
Antarctic	a	高
antique	n	高
anxiety	n	高
anxious	a	高
any	pron&a	高
anybody/=anyone	pron	高
anything	pron	高
anyway/=anyhow	ad	高
anywhere	ad	高
apart	ad&a	高
apartment	n	高
apologize	v	高
apology	n	高
apparent	a	高
appeal	v&n	高
appear	v	高
appearance	n	高
appendix	n	高
appetite	n	高
applaud	v&n	高
apple	n	高
applicant	n	高
application	n	高
apply	v	高
appoint	v	高
appointment	n	高
appreciate	v	高
appreciation	n	高
approach	n&v	高
appropriate	a	高
approval	n	高
approve	v	高
approximately	ad	高
apron	n	高
arbitrary	a	高
arch	n	高
architect	n	高
architecture	n	高
Arctic	a	高
are	v(be)	高
area	n	高
argue	v	高
argument	n	高
arise(arose,arisen)	v	高
arithmetic	n	高
arm	n&v	高
armchair	n	高
army	n	高
around	ad&prep	高
arrange	v	高
arrangement	n	高
arrest	v	高
arrival	n	高
arrive	v	高
arrow	n	高
art	n	高
article	n	高
artificial	a	高
artist	n	高
as	ad,conj&prep	高
ash	n	高
ashamed	a	高
Asia	n	高
Asian	a&n	高
aside	ad	高
ask	v	高
asleep	a	高
aspect	n	高
assess	v	高
assessment	n	高
assist	v	高
assistance	n	高
assistant	n	高
associate	v	高
association	n	高
assume	v	高
assumption	n	高
astonish	v	高
astronaut	n	高
astronomer	n	高
astronomy	n	高
at	prep	高
athlete	n	高
athletic	a	高
Atlantic	a	高
atmosphere	n	高
atom	n	高
attach	v	高
attack	v&n	高
attain	v	高
attempt	v&n	高
attend	v	高
attention	n	高
attitude	n	高
attract	v	高
attraction	n	高
attractive	a	高
audience	n	高
aunt	n	高
authentic	a	高
author	n	高
authority	n	高
automatic	a	高
autonomous	a	高
autumn	n	高
available	a	高
avenue	n	高
average	a&n	高
avoid	v	高
awake(awoke,awoken)	v&a	高
award	n	高
aware	a	高
away	ad	高
awesome	a	高
awful	a	高
awkward	a	高
baby	n	高
bachelor	n	高
back	ad,a&n	高
background	n	高
backward(s)	ad	高
bacon	n	高
bacterium(pl.bacteria)	n	高
bad(worse,worst)	a	高
badminton	n	高
bag	n	高
baggage	n	高
bakery	n	高
balance	n	高
balcony	n	高
ball	n	高
ballet	n	高
balloon	n	高
bamboo	n	高
ban	n&v	高
banana	n	高
band	n	高
bandage	n	高
bank	n	高
bar	n	高
barbecue	n	高
barber	n	高
barbershop	n	高
bare	a	高
bargain	n&v	高
bark	v&n	高
barrier	n	高
base	n	高
baseball	n	高
basement	n	高
basic	a	高
basin	n	高
basis	n	高
basket	n	高
basketball	n	高
bat	n	高
bath	n	高
bathe	v	高
bathroom	n	高
bathtub	n	高
battery	n	高
battle	n	高
bay	n	高
BC	abbr	高
be(am,is,are,was,were,being,been)	v	高
beach	n	高
bean	n	高
bean-curd	n	高
bear1	n	高
bear2	v	高
beard	n	高
beast	n	高
beat(beat,beaten)	v&n	高
beautiful	a	高
beauty	n	高
because	conj	高
become(became,become)	v	高
bed	n	高
beddings	n	高
bedroom	n	高
bee	n	高
beef	n	高
beer	n	高
before	prep,ad&conj	高
beg	v	高
begin(began,begun)	v	高
behalf	n	高
behave	v	高
behavior/behaviour	n	高
behind	prep&ad	高
being	n	高
belief	n	高
believe	v	高
bell	n	高
belly	n	高
belong	v	高
below	prep	高
belt	n	高
bench	n	高
bend(bent,bent)	v	高
beneath	prep	高
beneficial	a	高
benefit	n&v	高
bent	a&n	高
beside	prep	高
besides	prep&ad	高
betray	v	高
between	prep	高
beyond	prep	高
bicycle/bike	n	高
bid	v&n	高
big	a	高
bill	n	高
bingo	n	高
biochemistry	n	高
biography	n	高
biology	n	高
bird	n	高
birth	n	高
birthday	n	高
birthplace	n	高
biscuit	n	高
bishop	n	高
bit	n	高
bite(bit,bitten)	v	高
bitter	a	高
black	a&n	高
blackboard	n	高
blame	n&v	高
blank	n&a	高
blanket	n	高
bleed	v	高
bless	v	高
blind	a	高
block	n&v	高
blood	n	高
blouse	n	高
blow(blew,blown)	v	高
blue	n&a	高
board	n&v	高
boat	n	高
body	n	高
boil	v	高
bomb	n&v	高
bond	n&v	高
bone	n	高
bonus	n	高
book	n&v	高
boom	n&v	高
boot	n	高
booth	n	高
border	n	高
bored	a	高
boring	a	高
born	a	高
borrow	v	高
boss	n	高
botanical	a	高
botany	n	高
both	a&pron	高
bother	v	高
bottle	n	高
bottom	n	高
bounce	v	高
bound	a	高
boundary	n	高
bow	v&n	高
bowl	n	高
bowling	n	高
box	n	高
boxing	n	高
boy	n	高
boycott	v	高
brain	n	高
brake	n&v	高
branch	n	高
brand	n	高
brave	a	高
bravery	n	高
bread	n	高
break(broke,broken)	v&n	高
breakfast	n	高
breakthrough	n	高
breast	n	高
breath	n	高
breathe	v	高
breathless	a	高
brewery	n	高
brick	n	高
bride	n	高
bridegroom	n	高
bridge	n	高
brief	a	高
bright	a	高
brilliant	a	高
bring(brought,brought)	v	高
broad	a	高
broadcast(broadcast,broadcast或-ed,-ed)	v	高
brochure	n	高
broken	a	高
broom	n	高
brother	n	高
brown	n&a	高
brunch	n	高
brush	v&n	高
Buddhism	n	高
budget	n	高
buffet	n	高
build(built,built)	v	高
building	n	高
bunch	n	高
bungalow	n	高
burden	n	高
bureaucratic	a	高
burglar	n	高
burn(burnt,burnt或-ed,-ed)	v&n	高
burst	v	高
bury	v	高
bus	n	高
bush	n	高
business	n	高
businessman/woman(pl.businessmen/women)	n	高
busy	a	高
but	conj&prep	高
butcher	n&v	高
butter	n	高
butterfly	n	高
button	n&v	高
buy(bought,bought)	v	高
by	prep	高
bye	int	高
cab	n	高
cabbage	n	高
cafe	n	高
cafeteria	n	高
cage	n	高
cake	n	高
calculate	v	高
call	n&v	高
calm	a&v	高
camel	n	高
camera	n	高
camp	n&v	高
campaign	n	高
can1(could);		高
can’t/cannot	modal-v	高
can2	n	高
canal	n	高
cancel	v	高
cancer	n	高
candidate	n	高
candle	n	高
candy	n	高
canteen	n	高
cap	n	高
capital	n	高
capsule	n	高
captain	n	高
caption	n	高
car	n	高
carbon	n	高
card	n	高
care	n&v	高
careful	a	高
careless	a	高
carpenter	n	高
carpet	n	高
carriage	n	高
carrier	n	高
carrot	n	高
carry	v	高
cartoon	n	高
carve	v	高
case	n	高
cash	n&v	高
cassette	n	高
cast(cast,cast)	v	高
castle	n	高
casual	a	高
cat	n	高
catalog(ue)	n	高
catastrophe	n	高
catch(caught,caught)	v	高
category	n	高
cater	v	高
Catholic	a	高
cattle	n	高
cause	n&v	高
caution	n	高
cautious	a	高
cave	n	高
CD/(compact-disk)	n	高
ceiling	n	高
celebrate	v	高
celebration	n	高
cell	n	高
cent	n	高
centigrade	a	高
centimeter/centimetre	n	高
central	a	高
center/centre	n	高
century	n	高
ceremony	n	高
certain	a	高
certificate	n	高
chain	n	高
chair	n	高
chairman/woman(pl.chairmen/women)	n	高
chalk	n	高
challenge	n	高
challenging	a	高
champion	n	高
chance	n	高
change	n&v	高
changeable	a	高
channel	n	高
chant	v&n	高
chaos	n	高
chapter	n	高
character	n	高
characteristic	a&n	高
charge	v&n	高
chart	n	高
chat	n&v	高
cheap	a	高
cheat	n&v	高
check	n&v	高
cheek	n	高
cheer	n&v	高
cheerful	a	高
cheers	int	高
cheese	n	高
chef	n	高
chemical	a&n	高
chemist	n	高
chemistry	n	高
check/cheque	n	高
chess	n	高
chest	n	高
chew	v	高
chicken	n	高
chief	a&n	高
child(pl.children)	n	高
childhood	n	高
chocolate	n	高
choice	n	高
choir	n	高
choke	n&v	高
choose(chose,chosen)	v	高
chopstick	n	高
chorus	n	高
Christian	n	高
Christmas	n	高
church	n	高
cigar	n	高
cigaret(te)	n	高
cinema	n	高
circle	n&v	高
circuit	n	高
circulate	v	高
circumstance	n	高
circus	n	高
citizen	n	高
city	n	高
civil	a	高
civilian	n	高
civilization	n	高
clap	v	高
clarify	v	高
class	n	高
classic	a	高
classify	v	高
classmate	n	高
classroom	n	高
claw	n	高
clay	n	高
clean	v&a	高
cleaner	n	高
clear	a	高
clerk	n	高
clever	a	高
click	v	高
climate	n	高
climb	v	高
clinic	n	高
clock	n	高
clone	v	高
close	a&ad	高
cloth	n	高
clothes	n	高
clothing	n	高
cloud	n	高
cloudy	a	高
club	n	高
clumsy	a	高
coach	n	高
coal	n	高
coast	n	高
coat	n	高
cocoa	n	高
coffee	n	高
coin	n	高
coincidence	n	高
coke	n	高
cold	a&n	高
collar	n	高
colleague	n	高
collect	v	高
collection	n	高
college	n	高
collision	n	高
color/colour	n&v	高
comb	n&v	高
combine	v	高
come(came,come)	v	高
comedy	n	高
comfort	n	高
comfortable	a	高
command	n&v	高
comment	n	高
commercial	a	高
commit	v	高
commitment	n	高
committee	n	高
common	a	高
communicate	v	高
communication	n	高
communism	n	高
communist	n&a	高
companion	n	高
company	n	高
compare	v	高
compass	n	高
compensate	v	高
compete	v	高
competence	n	高
competition	n	高
complete	a&v	高
complex	a&n	高
component	n	高
composition	n	高
comprehension	n	高
compromise	v	高
compulsory	a	高
computer	n	高
concentrate	v	高
concept	n	高
concern	v&n	高
concert	n	高
conclude	v	高
conclusion	n	高
concrete	a	高
condemn	v	高
condition	n	高
conduct	v	高
conductor	n	高
conference	n	高
confident	a	高
confidential	a	高
confirm	v	高
conflict	n	高
confuse	v	高
congratulate	v	高
congratulation	n	高
connect	v	高
connection	n	高
conscience	n	高
consensus	n	高
consequence	n	高
conservation	n	高
conservative	a	高
consider	v	高
considerate	a	高
consideration	n	高
consist	v	高
consistent	a	高
constant	a	高
constitution	n	高
construct	v	高
construction	n	高
consult	v	高
consultant	n	高
consume	v	高
contain	v	高
container	n	高
contemporary	a	高
content1	n	高
content2	a	高
continent	n	高
continue	v	高
contradict	v	高
contradictory	a	高
contrary	n&a	高
contribute	v	高
contribution	n	高
control	v&n	高
controversial	a	高
convenience	n	高
convenient	a	高
conventional	a	高
conversation	n	高
convey	v	高
convince	v	高
cook	n&v	高
cooker	n	高
cookie	n	高
cool	a	高
copy	n&v	高
corn	n	高
corner	n	高
corporation	n	高
correct	v&a	高
correction	n	高
correspond	v	高
corrupt	a&v	高
cost	n&v	高
cozy/cosy	a	高
cottage	n	高
cotton	n&a	高
cough	n&v	高
could	modal-v	高
count	v	高
counter	n	高
country	n	高
countryside	n	高
couple	n	高
courage	n	高
course	n	高
court	n	高
courtyard	n	高
cousin	n	高
cover	n&v	高
cow	n	高
crash	v&n	高
crayon	n	高
crazy	a	高
cream	n	高
create	v	高
creature	n	高
credit	n	高
crew	n	高
crime	n	高
criminal	n	高
criterion(pl.criteria)	n	高
crop	n	高
cross	n&v	高
crossing	n	高
crossroads	n	高
crowd	n&v	高
cruel	a	高
cry	n&v	高
cube	n	高
cubic	a	高
cuisine	n	高
culture	n	高
cup	n	高
cupboard	n	高
cure	n&v	高
curious	a	高
currency	n	高
curriculum	n	高
curtain	n	高
cushion	n	高
custom	n	高
customer	n	高
customs	n	高
cut(cut,cut)	v&n	高
cycle	v	高
cyclist	n	高
dad/daddy	n	高
daily	a,ad&n	高
dam	n	高
damage	n&v	高
damp	a&n	高
dance	n&v	高
danger	n	高
dangerous	a	高
dare	v&modal-v	高
dark	a&n	高
darkness	n	高
dash	v&n	高
data	n	高
database	n	高
date	n&v	高
daughter	n	高
dawn	n	高
day	n	高
dead	a	高
deadline	n	高
deaf	a	高
deal	n	高
dear	a	高
death	n	高
debate	n&v	高
debt	n	高
decade	n	高
decide	v	高
decision	n	高
declare	v	高
decline	v	高
decorate	v	高
decoration	n	高
decrease	v	高
deed	n	高
deep	a&ad	高
deer	n	高
defeat	v	高
defense/defence	n	高
defend	v	高
degree	n	高
delay	n&v	高
delete	v&n	高
deliberately	ad	高
delicate	a	高
delicious	a	高
delight	n	高
delighted	a	高
deliver	v	高
demand	v	高
dentist	n	高
department(Dept.)	n	高
departure	n	高
depend	v	高
deposit	v&n	高
depth	n	高
describe	v	高
description	n	高
desert	v&n	高
deserve	v	高
design	v&n	高
desire	v&n	高
desk	n	高
desperate	a	高
dessert	n	高
destination	n	高
destroy	v	高
detective	n	高
determine	v	高
develop	v	高
development	n	高
devote	v	高
devotion	n	高
diagram	n	高
dial	v	高
dialog/dialogue	n	高
diamond	n	高
diary	n	高
dictation	n	高
dictionary	n	高
die	v	高
diet	n	高
differ	v	高
difference	n	高
different	a	高
difficult	a	高
difficulty	n	高
dig(dug,dug)	v	高
digest	v	高
digital	a	高
dignity	n	高
dilemma	n	高
dimension	n	高
dinner	n	高
dinosaur	n	高
dioxide	n	高
dip	v	高
diploma	n	高
direct	a&v	高
direction	n	高
director	n	高
directory	n	高
dirty	a	高
disability	n	高
disabled	a	高
disadvantage	n	高
disagree	v	高
disagreement	n	高
disappear	v	高
disappoint	v	高
disappointed	a	高
disaster	n	高
discount	n	高
discourage	v	高
discover	v	高
discovery	n	高
discrimination	n	高
discuss	v	高
discussion	n	高
disease	n	高
disgusting	a	高
dish	n	高
disk/disc	n	高
dislike	v	高
dismiss	v	高
distance	n	高
distant	a	高
distinction	n	高
distinguish	v	高
distribute	v	高
district	n	高
disturb	v	高
disturbing	a	高
dive	v	高
diverse	a	高
divide	v	高
division	n	高
divorce	v	高
dizzy	a	高
do(did,done)	v	高
doctor/Dr	n	高
document	n	高
dog	n	高
doll	n	高
dollar	n	高
donate	v	高
door	n	高
dormitory(dorm)	n	高
dot	n	高
double	a&n	高
doubt	n&v	高
down	prep&ad	高
download	n&v	高
downstairs	ad	高
downtown	ad,n&a	高
dozen	n	高
draft	n&v	高
drag	v	高
draw(drew,drawn)	v	高
drawback	n	高
drawer	n	高
dream(dreamt,dreamt或-ed,-ed)	n&v	高
dress	n&v	高
drill	n&v	高
drink(drank,drunk)	v	高
drive(drove,driven)	v	高
driver	n	高
drop	n&v	高
drug	n	高
drum	n	高
drunk	a	高
dry	v&a	高
duck	n	高
due	a	高
dull	a	高
dumpling	n	高
during	prep	高
dusk	n	高
dust	n	高
dustbin	n	高
dusty	a	高
duty	n	高
DVD/digital-versatile-disk	n	高
dynamic	a	高
dynasty	n	高
each	a&pron	高
eager	a	高
eagle	n	高
ear	n	高
early	a&ad	高
earn	v	高
earth	n	高
earthquake	n	高
east	a,ad&n	高
Easter	n	高
eastern	a	高
easy	a	高
eat(ate,eaten)	v	高
ecology	n	高
edge	n	高
edition	n	高
editor	n	高
educate	v	高
education	n	高
educator	n	高
effect	n	高
effort	n	高
egg	n	高
eggplant	n	高
either	a,conj&ad	高
elder	n	高
elect	v	高
electric(al)	a	高
electricity	n	高
electronic	a	高
elegant	a	高
elephant	n	高
else	ad	高
email/e-mail	n&v	高
embarrass	v	高
embassy	n	高
emergency	n	高
emperor	n	高
employ	v	高
empty	a	高
encourage	v	高
encouragement	n	高
end	n&v	高
ending	n	高
endless	a	高
enemy	n	高
energetic	a	高
energy	n	高
engine	n	高
engineer	n	高
enjoy	v	高
enjoyable	a	高
enlarge	v	高
enough	pron,a&ad	高
enquiry	n	高
enter	v	高
enterprise	n	高
entertainment	n	高
enthusiastic	a	高
entire	a	高
entrance	n	高
entry	n	高
envelope	n	高
environment	n	高
envy	v&n	高
equal	a&v	高
equality	n	高
equip	v	高
equipment	n	高
eraser	n	高
error	n	高
erupt	v	高
escape	n&v	高
especially	ad	高
essay	n	高
Europe	n	高
European	a&n	高
evaluate	v	高
even	ad	高
evening	n	高
event	n	高
eventually	ad	高
ever	ad	高
every	a	高
everybody	pron	高
everyday	a	高
everyone	pron	高
everything	pron	高
everywhere	ad	高
evidence	n	高
evident	a	高
evolution	n	高
exact	a	高
exam/examination	n	高
examine	v	高
example	n	高
excellent	a	高
except	prep	高
exchange	n&v	高
excite	v	高
excuse	n&v	高
exercise	n&v	高
exhibition	n	高
exist	v	高
existence	n	高
exit	n	高
expand	v	高
expect	v	高
expectation	n	高
expense	n	高
expensive	a	高
experience	n	高
experiment	n	高
expert	n	高
explain	v	高
explanation	n	高
explicit	a	高
explode	v	高
explore	v	高
export	n&v	高
expose	v	高
express	v&n	高
expression	n	高
extension	n	高
extra	a	高
extraordinary	a	高
extreme	a	高
eye	n	高
eyesight	n	高
face	n&v	高
facial	a	高
fact	n	高
factory	n	高
fade	v	高
fail	v&n	高
failure	n	高
fair1	a	高
fair2	n	高
faith	n	高
fall1(fell,fallen)	v	高
fall2(Am)/autumn	n	高
FALSE	a	高
familiar	a	高
family	n	高
famous	a	高
fan	n	高
fancy	n,v&a	高
fantastic	a	高
fantasy	n	高
far(farther,farthest或further,furthest)	a&ad	高
fare	n	高
farm	n	高
farmer	n	高
fast	a&ad	高
fasten	v	高
fat	n&a	高
father	n	高
fault	n	高
favor/favour	n	高
favorite/favourite	a&n	高
fax	n&v	高
fear	n	高
feast	n	高
feather	n	高
federal	a	高
fee	n	高
feed(fed,fed)	v	高
feel(felt,felt)	v	高
feeling	n	高
fellow	n	高
female	a&n	高
fence	n	高
ferry	n	高
festival	n&a	高
fetch	v	高
fever	n	高
few	pron&a	高
fiber/fibre	n	高
fiction	n	高
field	n	高
fierce	a	高
fight(fought,fought)	n&v	高
figure	n&v	高
file	n	高
fill	v	高
film	n&v	高
final	a	高
finance	n	高
find(found,found)	v	高
fine1	a	高
fine2	v	高
finger	n	高
fingernail	n	高
finish	v&n	高
fire	n&v	高
fireworks	n	高
firm1	n	高
firm2	a	高
fish	n&v	高
fisherman	n	高
fist	n	高
fit	a&v	高
fix	v	高
flag	n	高
flame	n	高
flash	n	高
flashlight	n	高
flat1	a	高
flat2	n	高
flee(fled,fled)	v	高
flesh	n	高
flexible	a	高
flight	n	高
float	v	高
flood	n&v	高
floor	n	高
flour	n	高
flow	v	高
flower	n	高
flu	n	高
fluency	n	高
fluent	a	高
fly1(flew,flown)	v	高
fly2	n	高
focus	v&n	高
fog	n	高
foggy	a	高
fold	v	高
folk	n&a	高
follow	v	高
fond	a	高
food	n	高
fool	n&v	高
foolish	a	高
foot(pl.feet)	n	高
football	n	高
for	prep&conj	高
forbid(forbade,forbidden)	v	高
force	v	高
forecast	n&v	高
forehead	n	高
foreign	a	高
foreigner	n	高
foresee(foresaw,foreseen)	v	高
forest	n	高
forever	ad	高
forget(forgot,forgot/forgotten)	v	高
forgetful	a	高
forgive(forgave,forgiven)	v	高
fork	n	高
form	n&v	高
format	n	高
former	a	高
fortnight	n	高
fortunate	a	高
fortune	n	高
forward	ad	高
foster	v	高
found	v	高
fountain	n	高
fox	n	高
fragile	a	高
fragrant	a	高
framework	n	高
franc	n	高
free	a	高
freedom	n	高
freeway	n	高
freeze(froze,frozen)	v	高
freezing	a	高
frequent	a	高
fresh	a	高
friction	n	高
refrigerator/fridge	n	高
friend	n	高
friendly	a	高
friendship	n	高
frighten	v	高
frog	n	高
from	prep	高
front	a&n	高
frontier	n	高
frost	n	高
fruit	n	高
fry	v	高
fuel	n	高
full	a	高
fun	n&a	高
function	n&v	高
fundamental	a	高
funeral	n	高
funny	a	高
fur	n	高
furnished	a	高
furniture	n	高
future	n	高
gain	v	高
gallery	n	高
gallon	n	高
game	n	高
garage	n	高
garbage	n	高
garden	n	高
garlic	n	高
garment	n	高
gas	n	高
gate	n	高
gather	v	高
gay	a	高
general	a&n	高
generation	n	高
generous	a	高
gentle	a	高
gentleman	n	高
geography	n	高
geometry	n	高
gesture	n	高
get(got,got)	v	高
gift	n	高
gifted	a	高
giraffe	n	高
girl	n	高
give(gave,given)	v	高
glad	a	高
glance	v	高
glare	v	高
glass	n	高
globe	n	高
glory	n	高
glove	n	高
glue	n	高
go(went,gone)	v	高
goal	n	高
goat	n	高
god	n	高
gold	n&a	高
golden	a	高
golf	n	高
good(better,best)	a	高
goods	n	高
goose(pl.geese)	n	高
govern	v	高
government	n	高
grade	n	高
gradual	a	高
graduate	v	高
graduation	n	高
grain	n	高
gram	n	高
grammar	n	高
grand	a	高
grandchild	n	高
granddaughter	n	高
grandma/grandmother	n	高
grandpa/grandfather	n	高
grandparents	n	高
grandson	n	高
granny	n	高
grape	n	高
graph	n	高
grasp	v	高
grass	n	高
grateful	a	高
gravity	n	高
great	a&ad	高
greedy	a	高
green	a&n	高
greengrocer	n	高
greet	v	高
greeting	n	高
gray/grey	a	高
grill	n	高
grocer	n	高
grocery	n	高
ground	n	高
group	n	高
grow(grew,grown)	v	高
growth	n	高
guarantee	v	高
guard	n	高
guess	v	高
guest	n	高
guidance	n	高
guide	n	高
guilty	a	高
guitar	n	高
gun	n	高
gymnasium/gym	n	高
gymnastics	n	高
habit	n	高
hair	n	高
haircut	n	高
half	a&n	高
hall	n	高
ham	n	高
hamburger	n	高
hammer	n	高
hand	n&v	高
handbag	n	高
handful	n	高
handkerchief	n	高
handle	n&v	高
handsome	a	高
handwriting	n	高
handy	a	高
hang(hung,hung或-ed,-ed)	v	高
happen	v	高
happiness	n	高
happy	a	高
harbor/harbour	n	高
hard	ad&a	高
hardly	ad	高
hardship	n	高
hardworking	a	高
harm	n&v	高
harmful	a	高
harmony	n	高
harvest	n&v	高
hat	n	高
hatch	v	高
hate	v&n	高
have(has,had,had)	v	高
he	pron	高
head	n&v	高
headache	n	高
headline	n	高
headmaster	n	高
headmistress	n	高
health	n	高
healthy	a	高
hear(heard,heard)	v	高
hearing	n	高
heart	n	高
heat	n	高
heaven	n	高
heavy	a	高
heel	n	高
height	n	高
helicopter	n	高
hello	int	高
helmet	n	高
help	n&v	高
helpful	a	高
hen	n	高
her	pron	高
herb	n	高
here	ad	高
hero	n	高
hers	pron	高
herself	pron	高
hesitate	v	高
hi	int	高
hide(hid,hidden)	v	高
high	a&ad	高
highway	n	高
hill	n	高
him	pron	高
himself	pron	高
hire	v	高
his	pron	高
history	n	高
hit(hit,hit)	v&n	高
hobby	n	高
hold(held,held)	v	高
hole	n	高
holiday	n	高
holy	a	高
home	n&ad	高
homeland	n	高
hometown	n	高
homework	n	高
honest	a	高
honey	n	高
honor/honour	n&v	高
hook	n&v	高
hope	n&v	高
hopeful	a	高
hopeless	a	高
horrible	a	高
horse	n	高
hospital	n	高
host	n&v	高
hostess	n	高
hot	a	高
hotdog	n	高
hotel	n	高
hour	n	高
house	n	高
housewife	n	高
housework	n	高
how	ad	高
however	ad&conj	高
howl	v	高
hug	v	高
huge	a	高
human	a&n	高
human-being	n	高
humorous	a	高
humor/humour	n	高
hunger	n	高
hungry	a	高
hunt	v	高
hunter	n	高
hurricane	n	高
hurry	v	高
hurt(hurt,hurt)	v	高
husband	n	高
hydrogen	n	高
I	pron	高
ice	n	高
ice-cream	n	高
idea	n	高
identity	n	高
identification	n	高
idiom	n	高
if	conj	高
ignore	v	高
ill	a	高
illegal	a	高
illness	n	高
imagine	v	高
immediately	ad	高
immigration	n	高
import	v&n	高
importance	n	高
important	a	高
impossible	a	高
impress	v	高
impression	n	高
improve	v	高
in	prep&ad	高
inch	n	高
incident	n	高
include	v	高
income	n	高
increase	v&n	高
indeed	a	高
independence	n	高
independent	a	高
indicate	v	高
industry	n	高
influence	n&v	高
inform	v	高
information	n	高
initial	a	高
injure	v	高
injury	n	高
ink	n	高
inn	n	高
innocent	a	高
insect	n	高
insert	v	高
inside	prep&ad	高
insist	v	高
inspect	v	高
inspire	v	高
instant	a	高
instead	ad	高
institute	n	高
institution	n	高
instruct	v	高
instruction	n	高
instrument	n	高
insurance	n	高
insure	v	高
intelligence	n	高
intend	v	高
intention	n	高
interest	n	高
interesting	a	高
international	a	高
Internet	n	高
interpreter	n	高
interrupt	v	高
interval	n	高
interview	n&v	高
into	prep	高
introduce	v	高
introduction	n	高
invent	v	高
invention	n	高
invitation	n	高
invite	v	高
iron	n&v	高
irrigation	n	高
is	v(be)	高
island	n	高
it	pron	高
its	pron	高
itself	pron	高
jacket	n	高
jam	n	高
jar	n	高
jaw	n	高
jazz	n	高
jeans	n	高
jeep	n	高
jet	n	高
jewelry/jewellery	n	高
job	n	高
jog	v	高
join	v	高
joke	n	高
journalist	n	高
journey	n	高
joy	n	高
judge	n&v	高
judgment/judgement	n	高
juice	n	高
jump	n&v	高
jungle	n	高
junior	a	高
just	a&ad	高
justice	n	高
kangaroo	n	高
keep(kept,kept)	v	高
kettle	n	高
key	n	高
keyboard	n	高
kick	v&n	高
kid	n	高
kill	v	高
kilogram(me)/kilo	n	高
kilometer/kilometre	n	高
kind1	n	高
kind2	a	高
kindergarten	n	高
kindness	n	高
king	n	高
kingdom	n	高
kiss	n&v	高
kitchen	n	高
kite	n	高
knee	n	高
knife(pl.knives)	n	高
knock	n&v	高
know(knew,known)	v	高
knowledge	n	高
laboratory/lab	n	高
labor/labour	n	高
lack	n&v	高
lady	n	高
lake	n	高
lamb	n	高
lame	a	高
lamp	n	高
land	n&v	高
language	n	高
lantern	n	高
lap	n	高
large	a	高
last	a&v	高
late	a&ad	高
latter	n	高
laugh	n&v	高
laughter	n	高
laundry	n	高
law	n	高
lawyer	n	高
lay(laid,laid)	v	高
lazy	a	高
lead(led,led)	v&n	高
leader	n	高
leaf(pl.leaves)	n	高
league	n	高
leak	v	高
learn(learnt,learnt或-ed,-ed)	v	高
least	n	高
leather	n	高
leave(left,left)	v	高
lecture	n	高
left	a,ad&n	高
leg	n	高
legal	a	高
lemon	n&a	高
lemonade	n	高
lend(lent,lent)	v	高
length	n	高
lesson	n	高
let(let,let)	v	高
letter	n	高
level	n	高
liberation	n	高
liberty	n	高
librarian	n	高
library	n	高
license	n	高
lid	n	高
lie1	n&v	高
lie2(lay,lain)	v	高
life(pl.lives)	n	高
lift	v&n	高
light	n,v&a	高
lightning	n	高
like	v&prep	高
likely	a	高
limit	v	高
line	n&v	高
link	v&n	高
lion	n	高
lip	n	高
liquid	n&a	高
list	n&v	高
listen	v	高
literature	n	高
literary	a	高
liter/litre	n	高
litter	v	高
little(less,least)	a	高
live	v&a	高
lively	a	高
load	n	高
loaf	n	高
local	a	高
lock	n&v	高
lonely	a	高
long	a&ad	高
look	n&v	高
loose	a	高
lorry	n	高
lose(lost,lost)	v	高
loss	n	高
lot	n	高
loud	a	高
lounge	n	高
love	n&v	高
lovely	a	高
low	a&ad	高
luck	n	高
lucky	a	高
luggage	n	高
lunch	n	高
lung	n	高
machine	n	高
mad	a	高
madam/madame	n	高
magazine	n	高
magic	a	高
maid	n	高
mail	n&v	高
mailbox	n	高
main	a	高
mainland	n	高
major	a	高
majority	n	高
make1	n	高
make2(made,made)	v	高
male	a&n	高
man(pl.men)	n	高
manage	v	高
manager	n	高
mankind	n	高
manner	n	高
many(more,most)	pron&a	高
map	n	高
maple	n	高
marathon	n	高
marble	n	高
march	n&v	高
mark	n&v	高
market	n	高
marriage	n	高
marry	v	高
mask	n&v	高
mass	n	高
master	v&n	高
mat	n	高
match	v&n	高
material	n	高
math(ematics)/maths	n	高
matter	n&v	高
mature	a	高
maximum	a&n	高
may	modal-v	高
maybe	ad	高
me	pron	高
meal	n	高
mean(meant,meant)	v	高
meaning	n	高
means	n	高
meanwhile	ad	高
measure	v	高
meat	n	高
medal	n	高
media	n	高
medical	a	高
medicine	n	高
medium	n	高
meet(met,met)	v&n	高
meeting	n	高
melon	n	高
member	n	高
memorial	n&a	高
memory	n	高
mend	v	高
mental	a	高
mention	n&v	高
menu	n	高
merchant	a&n	高
merciful	a	高
mercy	n	高
merely	ad	高
merry	a	高
mess	n	高
message	n	高
messy	a	高
metal	n&a	高
method	n	高
meter/metre	n	高
microscope	n	高
microwave	n	高
middle	n	高
midnight	n	高
might	modal-v	高
mild	a	高
mile	n	高
milk	n&v	高
millimeter/millimetre	n	高
millionaire	n	高
mind	n&v	高
mine1	n&v	高
mine2	pron	高
mineral	n	高
minibus	n	高
minimum	a	高
minister	n	高
ministry	n	高
minority	n	高
minus	prep&a	高
minute	n	高
mirror	n	高
miss1	n	高
miss2	v	高
missile	n	高
mist	n	高
mistake(mistook,mistaken)	v&n	高
mistaken	a	高
misunderstand(misunderstood,misunderstood)	v	高
mix	v	高
mixture	n	高
mobile	a	高
model	n	高
modem	n	高
modern	a	高
modest	a	高
mom/mum	n	高
moment	n	高
mommy/mummy	n	高
money	n	高
monitor	n	高
monkey	n	高
month	n	高
monument	n	高
moon	n	高
mop	n&v	高
moral	a&n	高
more(much,many)	a,ad&n	高
morning	n	高
Moslem	n	高
mosquito	n	高
most	a&ad	高
mother	n	高
motherland	n	高
motivation	n	高
motor	n	高
motorcycle	n	高
motto	n	高
mountain	n	高
mountainous	a	高
mourn	v	高
mouse(pl.mice)	n	高
moustache	n	高
mouth	n	高
move	v	高
movement	n	高
movie	n	高
Mr.(mister)	n	高
Mrs.(mistress)	n	高
Ms.	n	高
much	a&ad	高
mud	n	高
muddy	a	高
multiply	v	高
murder	v	高
museum	n	高
mushroom	n	高
music	n	高
musical	a&n	高
musician	n	高
must	modal-v	高
mustard	n	高
mutton	n	高
my	pron	高
myself	pron	高
nail	n	高
name	n&v	高
narrow	a	高
nation	n	高
national	a	高
nationality	n	高
nationwide	ad	高
native	a	高
natural	a	高
nature	n	高
navy	n	高
near	a,ad&prep	高
nearby	a	高
nearly	ad	高
neat	a	高
necessary	a	高
neck	n	高
necklace	n	高
need	n&modal-v	高
needle	n	高
negotiate	v	高
neighbor/neighbour	n	高
neighborhood/neighbourhood	n	高
neither	a	高
nephew	n	高
nervous	a	高
nest	n	高
net	n	高
network	n	高
never	ad	高
new	a	高
news	n	高
newspaper	n	高
next	a&ad	高
nice	a	高
niece	n	高
night	n	高
no	ad&a	高
No./number	n	高
noble	a	高
nobody	n&pron	高
nod	v	高
noise	n	高
noisy	a	高
none	pron	高
noodle	n	高
noon	n	高
nor	conj	高
normal	n&a	高
north	a,ad&n	高
northeast	n	高
northern	a	高
northwest	n	高
nose	n	高
not	ad	高
note	n&v	高
notebook	n	高
nothing	pron,n&a	高
notice	n&v	高
novel	n	高
novelist	n	高
now	ad	高
nowadays	ad	高
nowhere	ad	高
nuclear	a	高
numb	a	高
number	n	高
nurse	n	高
nursery	n	高
nut	n	高
nutrition	n	高
obey	v	高
object	n	高
observe	v	高
obtain	v	高
obvious	a	高
occupation	n	高
occupy	v	高
occur	v	高
ocean	n	高
Oceania	n	高
o'clock	n	高
of	prep	高
off	prep&ad	高
offence	n	高
offer	n&v	高
office	n	高
officer	n	高
official	n&a	高
offshore	a	高
often	ad	高
oh	int	高
oil	n&v	高
oilfield	n	高
okay/O.K./OK	ad	高
old	a	高
Olympic(s)	a&n	高
on	prep&ad	高
once	n,ad&conj	高
one	pron	高
oneself	pron	高
onion	n	高
only	a&ad	高
onto	prep	高
open	a&v	高
opening	n	高
opera	n	高
operate	v	高
operation	n	高
operator	n	高
opinion	n	高
oppose	v	高
opposite	n&a	高
optimistic	a	高
optional	a	高
or	conj	高
oral	a	高
orange	n&a	高
orbit	n	高
order	n&v	高
ordinary	a	高
organ	n	高
organize/organise	v	高
organization/organisation	n	高
origin	n	高
other	pron&a	高
otherwise	ad	高
ought	modal-v	高
our	pron	高
ours	pron	高
ourselves	pron	高
out	ad	高
outcome	n	高
outdoors	ad	高
outer	a	高
outgoing	a	高
outing	n	高
outline	n	高
output	n	高
outside	n,ad&prep	高
outspoken	a	高
outstanding	a	高
outward(s)	ad	高
oval	n&ad	高
over	prep&ad	高
overcoat	n	高
overcome	v	高
overhead	a	高
overlook	v	高
overweight	a	高
owe	v	高
own	a&v	高
owner	n	高
ownership	n	高
ox(pl.oxen)	n	高
oxygen	n	高
pace	n	高
Pacific	a	高
pack	n&v	高
package	n	高
packet	n	高
paddle	n	高
page	n	高
pain	n	高
painful	a	高
paint	n&v	高
painter	n	高
painting	n	高
pair	n	高
palace	n	高
pale	a	高
pan	n	高
pancake	n	高
panda	n	高
panic	a&v	高
paper	n	高
paperwork	n	高
paragraph	n	高
parallel	a&n	高
parcel	n	高
pardon	n	高
parent	n	高
park1	n	高
park2	v	高
parking	n	高
parrot	n	高
part	n,a&v	高
participate	v	高
particular	a	高
partly	ad	高
partner	n	高
part-time	a&ad	高
party	n	高
pass	v	高
passage	n	高
passenger	n	高
passer-by	n	高
passive	a	高
passport	n	高
past	ad,n&prep	高
patent	n	高
path	n	高
patience	n	高
patient1	n	高
patient2	a	高
pattern	n	高
pause	n&v	高
pavement	n	高
pay(paid,paid)	v&n	高
P.C./personal-computer	n	高
P.E./physical-education	n	高
pea	n	高
peace	n	高
peaceful	a	高
peach	n	高
pear	n	高
pedestrian	n	高
pen	n	高
pence	n	高
pencil	n	高
penny	n	高
pension	n	高
people	n	高
pepper	n	高
per	prep	高
percent	n	高
percentage	n	高
perfect	a	高
perform	v	高
performance	n	高
performer	n	高
perfume	n	高
perhaps	ad	高
period	n	高
permanent	a	高
permission	n	高
permit	v&n	高
person	n	高
personal	a	高
personnel	n	高
personally	ad	高
persuade	v	高
pest	n	高
pet	n	高
petrol	n	高
phenomenon(pl.phenomena)	n	高
photo(graph)	n	高
photographer	n	高
phrase	n	高
physical	a	高
physician	n	高
physicist	n	高
physics	n	高
pianist	n	高
piano	n	高
pick	v	高
picnic	n&v	高
picture	n	高
pie	n	高
piece	n	高
pig	n	高
pile	n	高
pill	n	高
pillow	n	高
pilot	n	高
pin	n&v	高
pine	n	高
pineapple	n	高
ping-pong	n	高
pink	a&n	高
pint	n	高
pioneer	n	高
pipe	n	高
pity	n	高
place	n&v	高
plain	a	高
plan	n&v	高
plane	n	高
planet	n	高
plant	v&n	高
plastic	a	高
plate	n	高
platform	n	高
play	v&n	高
playground	n	高
pleasant	a	高
please	v	高
pleased	a	高
pleasure	n	高
plenty	n	高
plot	v&n	高
plug	n	高
plus	v&prep	高
p.m./pm,P.M./PM	abbr	高
pocket	n	高
poem	n	高
poet	n	高
point	v&n	高
poison	n	高
poisonous	a	高
pole	n	高
police	n	高
policeman/woman(pl.policemen/policewomen)	n	高
policy	n	高
polish	v	高
polite	a	高
political	a	高
politician	n	高
politics	n	高
pollute	v	高
pollution	n	高
pond	n	高
pool	n	高
poor	a	高
pop/popular	a	高
popcorn	n	高
popular	a	高
population	n	高
pork	n	高
porridge	n	高
port	n	高
portable	a	高
porter	n	高
position	n	高
positive	a	高
possess	v	高
possession	n	高
possibility	n	高
possible	a	高
post1	n	高
post2	v&n	高
postage	n	高
postcard	n	高
postcode	n	高
poster	n	高
postman(pl.postmen)	n	高
postpone	v	高
pot	n	高
potato	n	高
potential	a	高
pound	n	高
pour	v	高
powder	n	高
power	n	高
powerful	a	高
practical	a	高
practice	n&v	高
practice/practise	v	高
praise	n&v	高
pray	v	高
prayer	n	高
precious	a	高
precise	a	高
predict	v	高
prefer	v	高
preference	n	高
pregnant	a	高
prejudice	n	高
premier	n	高
preparation	n	高
prepare	v	高
prescription	n	高
present1	a&v	高
present2	n	高
presentation	n	高
preserve	v	高
president	n	高
press1	v	高
press2	n	高
pressure	n	高
pretend	v	高
pretty	a	高
prevent	v	高
preview	v	高
previous	a	高
price	n	高
pride	n	高
primary	a	高
primitive	a	高
principle	n	高
print	v	高
prison	n	高
prisoner	n	高
private	a	高
privilege	n	高
prize	n	高
probably	ad	高
problem	n	高
procedure	n	高
process	n&v	高
produce	v	高
product	n	高
production	n	高
profession	n	高
professor	n	高
profit	n	高
program/programme	n	高
progress	n&v	高
prohibit	v	高
project	n	高
promise	n&v	高
promote	v	高
pronounce	v	高
pronunciation	n	高
proper	a	高
properly	ad	高
protect	v	高
protection	n	高
proud	a	高
prove	v	高
provide	v	高
province	n	高
psychology	n	高
pub	n	高
public	a&n	高
publish	v	高
pull	v&n	高
pulse	n	高
pump	v	高
punctual	a	高
punctuation	n	高
punish	v	高
punishment	n	高
pupil	n	高
purchase	v	高
pure	a	高
purple	n&a	高
purpose	n	高
purse	n	高
push	n&v	高
put(put,put)	v	高
puzzle	n	高
pyramid	n	高
quake	n&v	高
qualification	n	高
quality	n	高
quantity	n	高
quarrel	v&n	高
quarter	n	高
queen	n	高
question	v&n	高
questionnaire	n	高
queue	n&v	高
quick	a&ad	高
quiet	a	高
quilt	n	高
quit	v	高
quite	ad	高
quiz	n	高
rabbit	n	高
race	v&n	高
racial	a	高
radiation	n	高
radio	n	高
radioactive	a	高
radium	n	高
rag	n	高
rail	n	高
railroad/railway	n	高
rain	n&v	高
rainbow	n	高
raincoat	n	高
rainfall	n	高
rainy	a	高
raise	v	高
random	a	高
range	n&v	高
rank	n	高
rapid	a	高
rare	a	高
rat	n	高
rate	n&v	高
rather	ad	高
raw	a	高
ray	n	高
razor	n	高
reach	v	高
react	v	高
read(read,read)	v	高
reading	n	高
ready	a	高
real	a	高
realize/realise	v	高
reality	n	高
really	ad	高
reason	v&n	高
reasonable	a	高
rebuild(rebuilt,rebuilt)	v	高
receipt	n	高
receive	v	高
receiver	n	高
recent	a	高
reception	n	高
receptionist	n	高
recipe	n	高
recite	v	高
recognize/recognize	v	高
recommend	v	高
record	n&v	高
recorder	n	高
recover	v	高
recreation	n	高
rectangle	n&a	高
recycle	v	高
red	n&a	高
reduce	v	高
refer	v	高
referee	n	高
reference	n	高
reflect	v	高
reform	v&n	高
refresh	v	高
refuse	v	高
regard	v&n	高
regardless	a	高
register	n&v	高
regret	n&v	高
regular	a	高
regulation	n	高
reject	v	高
relate	v	高
relation	n	高
relationship	n	高
relative	n	高
relax	v	高
relay	n&v	高
relevant	a	高
reliable	a	高
relief	n	高
religion	n	高
religious	a	高
rely	v	高
remain	v	高
remark	n	高
remember	v	高
remind	v	高
remote	a	高
remove	v	高
rent	n&v	高
repair	n&v	高
repeat	v	高
replace	v	高
reply	n&v	高
report	n&v	高
reporter	n	高
represent	v	高
representative	n	高
republic	n	高
reputation	n	高
request	n	高
require	v	高
requirement	n	高
rescue	v	高
research	n	高
resemble	v	高
reservation	n	高
reserve	n&v	高
resign	v	高
resist	v	高
respect	v&n	高
respond	v	高
responsibility	n	高
rest	n&v	高
restaurant	n	高
restriction	n	高
result	n	高
retell	v	高
retire	v	高
return	v	高
review	v&n	高
revision	n	高
revolution	n	高
reward	n	高
rewind	v	高
rhyme	n&v	高
rice	n	高
rich	a	高
rid(rid,rid或ridded,ridded)	v	高
riddle	n	高
ridiculous	a	高
ride(rode,ridden)	v&n	高
right	n,a&ad	高
rigid	a	高
ring(rang,rung)	v&n	高
ripe	a	高
ripen	v	高
rise(rose,risen)	v	高
risk	n&v	高
river	n	高
road	n	高
roast	v	高
rob	v	高
robot	n	高
rock	n	高
rocket	n	高
role	n	高
roll	v&n	高
roof	n	高
room	n	高
rooster	n	高
root	n	高
rope	n	高
rose	n	高
rot	v	高
rough	a	高
round	ad,prep&a	高
roundabout	a&n	高
routine	n	高
row	n&v	高
royal	a	高
rubber	n	高
rubbish	n	高
rude	a	高
rugby	n	高
ruin	v&n	高
rule	n&v	高
ruler	n	高
run(ran,run)	v	高
rush	v	高
sacred	a	高
sacrifice	v	高
sad	a	高
sadness	n	高
safe	a	高
safety	n	高
sail	n&v	高
sailor	n	高
salad	n	高
salary	n	高
sale	n	高
salesgirl	n	高
salesman/woman(pl.salesmen/women)	n	高
salt	n	高
salty	a	高
salute	n&v	高
same	n&a	高
sand	n	高
sandwich	n	高
satellite	n	高
satisfaction	n	高
satisfy	v	高
saucer	n	高
sausage	n	高
save	v	高
say(said,said)	v	高
saying	n	高
scan	v	高
scar	n	高
scare	v	高
scarf	n	高
scene	n	高
scenery	n	高
skeptical/sceptical	a	高
schedule	n&v	高
scholar	n	高
scholarship	n	高
school	n	高
schoolbag	n	高
schoolboy/girl	n	高
schoolmate	n	高
science	n	高
scientific	a	高
scientist	n	高
scissors	n	高
scold	v	高
score	n&v	高
scratch	v&n	高
scream	n	高
screen	n	高
sculpture	n	高
sea	n	高
seagull	n	高
seal	n	高
search	n&v	高
seashell	n	高
seaside	n	高
season	n	高
seat	n	高
seaweed	n	高
second	a&n	高
secret	a&n	高
secretary	n	高
section	n	高
secure	a	高
security	n	高
see(saw,seen)	v	高
seed	n	高
seek	v	高
seem	v	高
seize	v	高
seldom	ad	高
select	v	高
self	n	高
selfish	a	高
sell(sold,sold)	v	高
semicircle	n	高
seminar	n	高
send(sent,sent)	v	高
senior	a&n	高
sense	n	高
sensitive	a	高
sentence	n	高
separate	v&a	高
separation	n	高
serious	a	高
servant	n	高
serve	v	高
service	n	高
session	n	高
set(set,set)	v&n	高
settle	v	高
settlement	n	高
settler	n	高
several	pron&a	高
severe	a	高
sew(sewed,sewn/sewed)	v	高
sex	n	高
shabby	a	高
shade	n	高
shadow	n	高
shake(shook,shaken)	v	高
shall	modal-v	高
shallow	a	高
shame	n	高
shape	n&v	高
share	v	高
shark	n	高
sharp	a	高
sharpen	v	高
sharpener	n	高
shave(shaved,shaved/shaven)	v	高
shaver	n	高
she	pron	高
sheep(pl.sheep)	n	高
sheet	n	高
shelf(pl.shelves)	n	高
shelter	n	高
shine(shone,shone)	v	高
ship	n&v	高
shirt	n	高
shock	v	高
shoe	n	高
shoot(shot,shot)	v&n	高
shop	v&n	高
shopkeeper	n	高
shopping	n	高
shore	n	高
short	a	高
shortcoming	n	高
shortly	ad	高
shorts	n	高
shot	n	高
should	modal-v	高
shoulder	n	高
shout	n&v	高
show(showed,shown/showed)	v&n	高
shower	n	高
shrink(shrank,shrunk或shrunk,shrunken)	v	高
shut(shut,shut)	v	高
shuttle	n	高
shy	a	高
sick	a	高
sickness	n	高
side	n	高
sidewalk/sideroad	n	高
sideways	ad	高
sigh	v&n	高
sight	n	高
sightseeing	n	高
signal	n	高
signature	n	高
significance	n	高
silence	n	高
silent	a	高
silk	n	高
silly	a	高
silver	n	高
similar	a	高
simple	a	高
simplify	v	高
since	ad,conj&prep	高
sincerely	ad	高
sing(sang,sung)	v	高
single	a	高
sink(sank,sunk)	v&n	高
sir	n	高
sister	n	高
sit(sat,sat)	v	高
situation	n	高
size	n	高
skate	v	高
skateboard	n	高
ski	n&v	高
skilful	a	高
skill	n	高
skin	n	高
skip	v	高
skirt	n	高
sky	n	高
skyscraper	n	高
slave	n	高
slavery	n	高
sleep1	n	高
sleep2(slept,slept)	v	高
sleepy	a	高
sleeve	n	高
slice	n	高
slide	n&v	高
slight	a	高
slim	a	高
slip	n	高
slow	ad	高
small	a	高
smart	a	高
smell(smelt,smelt或-ed,-ed)	v&n	高
smile	n&v	高
smog	n	高
smoke	n&v	高
smoker	n	高
smooth	a	高
snake	n	高
sneaker	n	高
sneeze	v	高
sniff	v	高
snow	n&v	高
snowy	a	高
so	ad&conj	高
soap	n	高
sob	n&v	高
soccer	n	高
social	a	高
socialism	n	高
socialist	a	高
society	n	高
sock	n	高
socket	n	高
sofa	n	高
soft	a	高
software	n	高
soil	n	高
solar	a	高
soldier	n	高
solid	a&n	高
some	a&pron	高
somebody	pron	高
somehow	ad	高
someone	pron	高
something	pron	高
sometimes	ad	高
somewhere	ad	高
son	n	高
song	n	高
soon	ad	高
sorrow	n	高
sorry	a	高
sort	v&n	高
soul	n	高
sound	v&n	高
soup	n	高
sour	a	高
south	a,ad&n	高
southeast	n	高
southern	a	高
southwest	n	高
souvenir	n	高
sow(sowed,sown/-ed)	v	高
space	n	高
spaceship	n	高
spade	n	高
spare	a	高
sparrow	n	高
speak(spoke,spoken)	v	高
speaker	n	高
spear	n	高
special	a	高
specialist	n	高
specific	a	高
speech	n	高
speed	n&v	高
spell	v	高
spelling	n	高
spend(spent,spent)	v	高
spin	v&n	高
spirit	n	高
spiritual	a	高
spit	v	高
splendid	a	高
split	v	高
spoken	a	高
spokesman/woman(pl.spokesmen/women)	n	高
sponsor	n	高
spoon	n	高
spoonful	n	高
sport	n	高
spot	n&v	高
spray	n&v	高
spread(spread,spread)	v	高
spring	n	高
spy	n&v	高
square	n&a	高
squeeze	v	高
squirrel	n	高
stable	a	高
stadium	n	高
staff	n	高
stage	n	高
stain	n	高
stainless	a	高
stair	n	高
stamp	n	高
stand(stood,stood)	v&n	高
standard	n&a	高
star	n	高
stare	v	高
start	v	高
starvation	n	高
starve	v	高
state	n	高
station	n	高
statement	n	高
statesman/woman(pl.statesmen/women)	n	高
statistics	n	高
statue	n	高
status	n	高
stay	n&v	高
steady	a	高
steak	n	高
steal(stole,stolen)	v	高
steam	n	高
steel	n	高
steep	a	高
step	n&v	高
steward	n	高
stewardess	n	高
stick(stuck,stuck)	v&n	高
still	a&ad	高
stocking	n	高
stomach	n	高
stone	n	高
stop	n&v	高
storage	n	高
store	n&v	高
storm	n	高
story	n	高
stout	a	高
stove	n	高
straight	a&ad	高
straightforward	a&adv	高
strait	n	高
strange	a	高
stranger	n	高
straw	n	高
strawberry	n	高
stream	n	高
street	n	高
strength	n	高
strengthen	v	高
stress	n&v	高
strict	a	高
strike(struck,struck/stricken)	v&n	高
string	n	高
strong	a	高
struggle	v	高
stubborn	a	高
student	n	高
studio	n	高
study	v&n	高
stupid	a	高
style	n	高
subject	n	高
subjective	a	高
submit	v	高
subscribe	v	高
substitute	v	高
succeed	v	高
success	n	高
successful	a	高
such	ad,pron&a	高
suck	v	高
sudden	a	高
suffer	v	高
suffering	n	高
sugar	n	高
suggest	v	高
suggestion	n	高
suit	v&n	高
suitable	a	高
suitcase	n	高
suite	n	高
summary	n	高
summer	n	高
sun	n	高
sunburnt	a	高
sunlight	n	高
sunny	a	高
sunshine	n	高
super	a	高
superb	a	高
superior	a&n	高
supermarket	n	高
supper	n	高
supply	v&n	高
support	v&n	高
suppose	v	高
supreme	a	高
sure	a&ad	高
surface	n	高
surgeon	n	高
surplus	n	高
surprise	v&n	高
surround	v	高
surrounding	a	高
survive	v	高
survival	n	高
suspect	v&n	高
suspension	n	高
swallow	v	高
swap	v	高
swear(swore,sworn)	v	高
sweat	n	高
sweater	n	高
sweep(swept,swept)	v	高
sweet	n&a	高
swell(swelled,swollen)	v	高
swift	a	高
swim(swam,swum)	v	高
swing	v&n	高
switch	v&n	高
sword	n	高
symbol	n	高
sympathy	n	高
symphony	n	高
symptom	n	高
system	n	高
systematic	a	高
table	n	高
table-tennis	n	高
tablet	n	高
tail	n	高
tailor	n	高
take(took,taken)	v	高
tale	n	高
talent	n	高
talk	n&v	高
tall	a	高
tank	n	高
tap	n	高
tape	n	高
target	n&v	高
task	n	高
taste	n&v	高
tasteless	a	高
tasty	a	高
tax	n	高
taxi	n	高
taxpayer	n	高
tea	n	高
teach(taught,taught)	v	高
teacher	n	高
team	n	高
teamwork	n	高
teapot	n	高
tear(tore,torn)	v&n	高
tease	v	高
technical	a	高
technique	n	高
technology	n	高
teenager	n	高
telephone/phone/tel.	n&v	高
telescope	n	高
television	n	高
tell(told,told)	v	高
temperature	n	高
temple	n	高
temporary	a	高
tend	v	高
tendency	n	高
tennis	n	高
tense	a	高
tension	n	高
tent	n	高
tentative	a	高
term	n	高
terminal	a&n	高
terrible	a	高
terrify	v	高
terror	n	高
test	v&n	高
text	n	高
textbook	n	高
than	conj	高
thank	v&n	高
thankful	a	高
that	pron,conj&ad	高
the	art	高
theater/theatre	n	高
theft	n	高
their	pron	高
theirs	pron	高
them	pron	高
theme	n	高
themselves	pron	高
then	ad	高
theoretical	a	高
theory	n	高
there	int,n&ad	高
therefore	ad	高
thermos	n	高
these	a&pron	高
they	pron	高
thick	a	高
thief(pl.thieves)	n	高
thin	a	高
thing	n	高
think(thought,thought)	v	高
thinking	n	高
thirst	n	高
this	a&pron	高
thorough	a	高
those	a&pron	高
though	conj	高
thought	n	高
thread	n	高
thrill	n&v	高
thriller	n	高
throat	n	高
through	prep&ad	高
throughout	prep	高
throw(threw,thrown)	v	高
thunder	n&v	高
thunderstorm	n	高
thus	ad	高
tick	v	高
ticket	n	高
tidy	a&v	高
tie	v&n	高
tiger	n	高
tight	a	高
till	conj&prep	高
time	n&v	高
timetable	n	高
tin	n	高
tiny	a	高
tip	n&v	高
tire	v	高
tired	a	高
tiresome	a	高
tissue	n	高
title	n	高
to	prep	高
toast	v&n	高
tobacco	n	高
today	ad&n	高
together	ad	高
toilet	n	高
tolerate	v	高
tomato	n	高
tomb	n	高
tomorrow	ad&n	高
ton	n	高
tongue	n	高
tonight	ad&n	高
too	ad	高
tool	n	高
tooth(pl.teeth)	n	高
toothache	n	高
toothbrush	n	高
toothpaste	n	高
top	n	高
topic	n	高
tortoise	n	高
total	a,n&v	高
touch	v	高
tough	a	高
tour	n	高
tourism	n	高
tourist	n	高
tournament	n	高
toward(s)	prep	高
towel	n	高
tower	n	高
town	n	高
toy	n	高
track	n	高
tractor	n	高
trade	n&v	高
tradition	n	高
traditional	a	高
traffic	n	高
train	n&v	高
training	n	高
tram	n	高
transform	v	高
translate	v	高
translation	n	高
translator	n	高
transparent	a	高
transport	n&v	高
trap	n&v	高
travel	n&v	高
traveler/traveller	n	高
treasure	n	高
treat	v	高
treatment	n	高
tree	n	高
tremble	v	高
trend	n	高
trial	n	高
triangle	n	高
trick	n	高
trip	n	高
trolleybus	n	高
troop	n	高
trouble	v&n	高
troublesome	a	高
trousers	n	高
truck	n	高
TRUE	a	高
truly	ad	高
trunk	n	高
trust	v	高
truth	n	高
try	v	高
T-shirt	n	高
tube	n	高
tune	n	高
turkey	n	高
turn	v&n	高
turning	n	高
tutor	n	高
TV/television	n	高
twice	ad	高
twin	n	高
twist	v&n	高
type	v	高
typewriter	n	高
typical	a	高
typhoon	n	高
typist	n	高
tire/tyre	n	高
ugly	a	高
umbrella	n	高
unable	a	高
unbearable	a	高
unbelievable	a	高
uncertain	a	高
uncle	n	高
uncomfortable	a	高
unconditional	a	高
unconscious	a	高
under	ad&prep	高
underground	a&n	高
underline	v	高
understand(understood,understood)	v	高
undertake(undertook,undertaken)	v	高
underwear	n	高
unemployment	n	高
unfair	a	高
unfit	a	高
unfortunate	a	高
uniform	n	高
union	n	高
unique	a	高
unit	n	高
unite	v	高
universal	a	高
universe	n	高
university	n	高
unless	conj	高
unlike	prep	高
unrest	n	高
until	prep&conj	高
unusual	a	高
unwilling	a	高
up	ad,a,n&prep	高
update	v&n	高
upon	prep	高
upper	a	高
upset	a	高
upstairs	ad	高
upward(s)	ad	高
urban	a	高
urge	v	高
urgent	a	高
us	pron	高
use	n&v	高
used	a	高
useful	a	高
useless	a	高
user	n	高
usual	a	高
vacation	n	高
vacant	a	高
vague	a	高
vain	n	高
valid	a	高
valley	n	高
valuable	a	高
value	n	高
variety	n	高
various	a	高
vase	n	高
vast	a	高
VCD/versatile-compact-disk	n	高
vegetable	n	高
vehicle	n	高
version	n	高
vertical	a	高
very	ad	高
vest	n	高
via	prep	高
vice	n	高
victim	n	高
victory	n	高
video	n	高
videophone	n	高
view	n	高
village	n	高
villager	n	高
vinegar	n	高
violate	v	高
violence	n	高
violent	a	高
violin	n	高
violinist	n	高
virtue	n	高
virus	n	高
visa	n	高
visit	n&v	高
visitor	n	高
visual	a	高
vital	a	高
vivid	a	高
vocabulary	n	高
voice	n	高
volcano	n	高
volleyball	n	高
voluntary	a	高
volunteer	n&v	高
vote	v	高
voyage	n	高
wag	v	高
wage	n	高
waist	n	高
wait	v	高
waiter	n	高
waiting-room	n	高
waitress	n	高
wake(woke,woken)	v	高
walk	n&v	高
wall	n	高
wallet	n	高
walnut	n	高
wander	v	高
want	v	高
war	n	高
ward	n	高
warehouse	n	高
warm	a	高
warmth	n	高
warn	v	高
wash	v&n	高
washroom	n	高
waste	n&v	高
watch	v&n	高
water	n&v	高
watermelon	n	高
wave	n&v	高
wax	n	高
way	n	高
we	pron	高
web	n	高
website	n	高
weak	a	高
weakness	n	高
wealth	n	高
wealthy	a	高
wear(wore,worn)	v	高
weather	n	高
wedding	n	高
weed	n	高
week	n	高
weekday	n	高
weekend	n	高
weekly	a	高
weep	v	高
weigh	v	高
weight	n	高
welcome	int,n,v&a	高
welfare	n	高
well1	n	高
well2(better,best)	ad,a&int	高
west	a,ad&n	高
western	a	高
westward(s)	ad	高
wet	a	高
whale	n	高
what	pron&a	高
whatever	conj&pron	高
wheat	n	高
wheel	n	高
when	conj&ad	高
whenever	conj	高
where	conj&ad	高
wherever	conj	高
whether	conj	高
which	pron&a	高
whichever	pron	高
while	conj&n	高
whisper	v	高
whistle	n	高
white	a&n	高
who	pron	高
whole	a	高
whom	pron	高
whose	pron	高
why	ad&int	高
wide	a	高
widespread	a	高
widow	n	高
wife	n	高
wild	a	高
wildlife	n	高
will1	n	高
will2(would)	modal-v	高
willing	a	高
win(won,won)	v	高
wind1	n	高
wind2(wound,wound)	v	高
window	n	高
windy	a	高
wine	n	高
wing	n	高
winner	n	高
winter	n	高
wipe	v	高
wire	n	高
wisdom	n	高
wise	a	高
wish	n&v	高
with	prep	高
withdraw	v	高
within	prep	高
without	prep	高
witness	v&n	高
wolf(pl.wolves)	n	高
woman(pl.women)	n	高
wonder	v&n	高
wonderful	a	高
wood	n	高
wool	n	高
woolen/woollen	a	高
word	n	高
work	n&v	高
worker	n	高
world	n	高
worldwide	a	高
worm	n	高
worn	a	高
worried	a	高
worry	n&v	高
worth	a	高
worthwhile	a	高
worthy	a	高
would	modal-v	高
wound	v&n	高
wrestle	v	高
wrinkle	n	高
wrist	n	高
write(wrote,written)	v	高
wrong	a	高
X-ray	n	高
yard	n	高
yawn	v	高
year	n	高
yell	v	高
yellow	a&n	高
yes	ad	高
yesterday	n&ad	高
yet	ad	高
yoghurt	n	高
you	pron	高
young	a	高
your	pron	高
yours	pron	高
yourself(pl.yourselves)	pron	高
youth	n	高
yummy	a	高
zebra	n	高
zero	n&num	高
zip	v&n	高
zipper	n	高
zone	n	高
zoo	n	高
zoom	v	高
one		高
two		高
three		高
four		高
five		高
six		高
seven		高
eight		高
nine		高
ten		高
eleven		高
twelve		高
thirteen		高
fourteen		高
fifteen		高
sixteen		高
seventeen		高
eighteen		高
nineteen		高
twenty		高
twenty-one		高
twenty-two		高
twenty-three		高
thirty		高
forty		高
fifty		高
sixty		高
seventy		高
eighty		高
ninety		高
hundred		高
thousand		高
million		高
billion		高
first		高
second		高
third		高
fourth		高
fifth		高
sixth		高
seventh		高
eighth		高
ninth		高
tenth		高
eleventh		高
twelfth		高
thirteenth		高
fourteenth		高
fifteenth		高
sixteenth		高
seventeenth		高
eighteenth		高
nineteenth		高
twentieth		高
twenty-first		高
twenty-second		高
twenty-third		高
thirtieth		高
fortieth		高
fiftieth		高
sixtieth		高
seventieth		高
eightieth		高
ninetieth		高
hundredth		高
thousandth		高
millionth		高
billionth		高
January/Jan.		高
February/Feb.		高
March/Mar.		高
April/Apr.		高
May/May		高
June/Jun.		高
July/Jul.		高
August/Aug.		高
September/Sept.		高
October/Oct.		高
November/Nov.		高
December/Dec.		高
Monday/Mon.		高
Tuesday/Tues.		高
Wednesday/Wed.		高
Thursday/Thurs.		高
Friday/Fri.		高
Saturday/Sat.		高
Sunday/Sun.		高
