a/an	小
about	小
above	小
across	小
act	小
afraid	小
after	小
afternoon	小
again	小
air	小
all	小
along	小
always	小
be/(am/is/are)	小
#America	小
#American	小
and	小
angry	小
animal	小
answer	小
any	小
apple	小
April	小
#be/(am/is/are)	小
art	小
ask	小
asleep	小
at	小
August	小
aunt	小
autumn	小
away	小
baby	小
back	小
bad	小
bag	小
ball	小
banana	小
basketball	小
bat	小
bath	小
beach	小
bean	小
bear	小
beautiful	小
because	小
become	小
bed	小
beer	小
before	小
begin	小
behind	小
bell	小
beside	小
between	小
bike/bicycle	小
big	小
bird	小
birthday	小
biscuit	小
black	小
blow	小
blue	小
boat	小
body	小
bone	小
book	小
borrow	小
both	小
bottle	小
bowl	小
box	小
boy	小
brave	小
bread	小
break	小
breakfast	小
bright	小
brother	小
brown	小
brush	小
bus	小
busy	小
but	小
butter	小
butterfly	小
buy	小
by	小
cake	小
call	小
camera	小
can	小
candle	小
cap	小
car	小
card	小
cat	小
catch	小
chair	小
chalk	小
channel	小
cheap	小
chicken	小
child/children	小
#China	小
#Chinese	小
chip	小
chocolate	小
Christmas	小
cinema	小
circle	小
city	小
class	小
clean	小
clever	小
climb	小
clock	小
close	小
clothes	小
cloud	小
cloudy	小
coat	小
coffee	小
cold	小
colo(u)r	小
come	小
computer	小
cook	小
cool	小
copy	小
corn	小
correct	小
count	小
cousin	小
cow	小
cross	小
cry	小
cup	小
cut	小
dad	小
dance	小
dangerous	小
dark	小
date	小
daughter	小
day	小
dear	小
December	小
deep	小
desk	小
dialog(ue)	小
different	小
difficult	小
dig	小
dinner	小
dirty	小
dish	小
do	小
doctor/Dr.	小
dog	小
doll	小
door	小
down	小
draw	小
dress	小
drink	小
drive	小
drum	小
dry	小
duck	小
ear	小
early	小
east	小
easy	小
eat	小
egg	小
eight	小
eleven	小
empty	小
engineer	小
#England	小
#English	小
enjoy	小
evening	小
every	小
exercise	小
eye	小
face	小
fall	小
false	小
family	小
fan	小
far	小
farm	小
fast	小
fat	小
father	小
favo(u)rite	小
February	小
feed	小
feel	小
film	小
find	小
fine	小
finger	小
fire	小
first	小
fish	小
five	小
flag	小
floor	小
flower	小
fly	小
fold	小
follow	小
food	小
foot	小
football	小
for	小
four	小
fox	小
free	小
Friday	小
fridge	小
friend	小
from	小
front	小
fruit	小
full	小
funny	小
game	小
garden	小
get	小
gift	小
girl	小
give	小
glad	小
glass	小
glue	小
go	小
good	小
goodby(e)	小
grade	小
grass	小
great	小
green	小
gray/grey	小
group	小
guess	小
guitar	小
gun	小
hair	小
half	小
hall	小
hand	小
happy	小
hard	小
hat	小
have/has	小
he	小
head	小
hear	小
heavy	小
hello	小
help	小
her	小
here	小
hers	小
hi	小
hide	小
high	小
hill	小
him	小
his	小
bobby	小
home	小
horse	小
hospital	小
hot	小
house	小
how	小
hundred	小
hungry	小
hurry	小
I	小
ice	小
ice-cream	小
idea	小
improve	小
in	小
ink	小
interesting	小
#be/(am/is/are)	小
it	小
its	小
jacket	小
jam	小
January	小
jelly	小
job	小
juice	小
July	小
jump	小
June	小
kilo	小
kitchen	小
knee	小
knife	小
knock	小
know	小
lady	小
lake	小
lamp	小
large	小
late	小
laugh	小
leaf	小
learn	小
left	小
leg	小
lesson	小
let	小
letter	小
library	小
light	小
like	小
list	小
listen	小
little	小
live	小
local	小
location	小
long	小
look	小
lot	小
loud	小
love	小
low	小
lunch	小
make	小
man	小
many	小
map	小
March	小
match	小
math(s)	小
May	小
may	小
me	小
meat	小
meet	小
milk	小
mine	小
minus	小
mirror	小
Miss	小
Mr.(Mister)	小
Monday	小
money	小
month	小
moon	小
mother	小
mouse/mice	小
mouth	小
much	小
mum	小
music	小
must	小
my	小
name	小
near	小
need	小
net	小
new	小
news	小
newspaper	小
next	小
nice	小
night	小
nine	小
no	小
nod	小
noise	小
north	小
nose	小
not	小
November	小
now	小
number	小
nurse	小
October	小
of	小
office	小
often	小
old	小
on	小
one	小
open	小
or	小
orange	小
our	小
ours	小
out	小
over	小
page	小
paint	小
pair	小
panda	小
paper	小
park	小
party	小
past	小
peach	小
pear	小
pen	小
pencil	小
people	小
pet	小
telephone/phone	小
photo(graph)	小
pick	小
picnic	小
picture	小
piece	小
pig	小
pineapple	小
pink	小
pizza	小
place	小
plane	小
plant	小
plate	小
play	小
please	小
pleasure	小
plus	小
point	小
policeman	小
pool	小
post	小
potato	小
present	小
primary	小
pull	小
pupil	小
purple	小
push	小
put	小
quarter	小
question	小
quick	小
quiet	小
rabbit	小
radio	小
rain	小
rainy	小
read	小
ready	小
rectangle	小
red	小
restaurant	小
rice	小
riddle	小
ride	小
right	小
river	小
road	小
robot	小
room	小
rope	小
rose	小
rough	小
round	小
rubber	小
ruler	小
run	小
sad	小
safe	小
salad	小
same	小
sandwich	小
Saturday	小
sausage	小
save	小
say	小
scarf	小
school	小
science	小
scissors	小
sea	小
season	小
second	小
see	小
seed	小
sell	小
sense	小
sentence	小
September	小
seven	小
shake	小
shape	小
share	小
sharp	小
she	小
sheep	小
shelf	小
shell	小
shine	小
ship	小
shirt	小
shoe	小
shop	小
short	小
shoulder	小
shout	小
show	小
shut	小
sick	小
sign	小
sing	小
sir	小
sister	小
sit	小
six	小
size	小
sky	小
sleep	小
slide	小
slow	小
small	小
smart	小
smell	小
smile	小
smoke	小
smooth	小
snake	小
snow	小
snowy	小
so	小
soap	小
sock	小
soft	小
soldier	小
some	小
sometimes	小
son	小
song	小
sorry	小
soup	小
south	小
speak	小
spell	小
spoon	小
sport	小
spring	小
square	小
stamp	小
stand	小
star	小
start	小
station	小
stop	小
storm	小
story	小
strawberry	小
street	小
strong	小
student	小
study	小
subject	小
sugar	小
summer	小
sun	小
sunny	小
Sunday	小
supermarket	小
supper	小
sure	小
survey	小
sweep	小
swim	小
swing	小
table	小
tail	小
take	小
talk	小
tall	小
tape	小
taste	小
taxi	小
tea	小
teacher	小
#telephone/phone	小
television/TV	小
tell	小
ten	小
tennis	小
terrible	小
thank	小
that	小
the	小
theater/theatre	小
their	小
theirs	小
them	小
then	小
there	小
these	小
they	小
thick	小
thin	小
thing	小
think	小
third	小
this	小
those	小
thousand	小
three	小
throw	小
Thursday	小
ticket	小
tiger	小
time	小
tired	小
to	小
today	小
together	小
toilet	小
tomato	小
tomorrow	小
tongue	小
tonight	小
too	小
tooth	小
top	小
touch	小
towel	小
tower	小
town	小
toy	小
traffic	小
train	小
tree	小
triangle	小
trousers	小
truck	小
true	小
try	小
Tuesday	小
turn	小
twelve	小
twice	小
two	小
ugly	小
uncle	小
under	小
underground	小
understand	小
uniform	小
unit	小
up	小
us	小
use	小
usually	小
van	小
vegetable	小
very	小
video	小
violin	小
visit	小
voice	小
volleyball	小
wait	小
wake	小
walk	小
wall	小
want	小
warm	小
wash	小
watch	小
water	小
wave	小
way	小
we	小
weak	小
wear	小
weather	小
Wednesday	小
week	小
welcome	小
well	小
west	小
wet	小
what	小
when	小
where	小
which	小
white	小
who	小
whose	小
why	小
wild	小
will	小
win	小
wind	小
windy	小
window	小
winter	小
wish	小
with	小
woman	小
word	小
work	小
worker	小
world	小
would	小
write	小
wrong	小
year	小
yellow	小
yes/yeah	小
you	小
young	小
your	小
yours	小
zebra	小
zero	小
zoo	小
abandon	初
ability	初
able	初
#about	初
#above	初
abroad	初
accept	初
access	初
accident	初
according (to)	初
account	初
accurate	初
achieve	初
#act	初
activity	初
actual	初
add	初
#address	初
administration	初
admire	初
admit	初
adopt	初
adult	初
advantage	初
advertisement	初
advice	初
affair	初
affect	初
afford	初
#Africa	初
#after	初
afterward(s)	初
against	初
age	初
agent	初
ago	初
agree	初
ahead	初
aid	初
aim	初
aircraft	初
airline	初
airport	初
alarm	初
alcohol	初
alive	初
allow	初
almost	初
alone	初
#along	初
already	初
also	初
alternative	初
although/though	初
amaze/amazing	初
ambition	初
among	初
amount	初
amuse/amusing	初
analyze/-yse	初
ancient	初
angle	初
announce	初
annoy	初
another	初
anxious	初
anybody/anyone	初
anything	初
anyway	初
anywhere	初
apartment	初
apologize	初
apparently	初
appeal	初
appear	初
apply	初
appoint	初
appreciate	初
approach	初
appropriate	初
approve	初
architect	初
area	初
argue	初
arm	初
army	初
around	初
arrange	初
arrest	初
arrive	初
article	初
artificial	初
as	初
ashamed	初
#Asia	初
aside	初
aspect	初
assistant	初
association	初
assume	初
astonish	初
atmosphere	初
attach	初
attack	初
attempt	初
attend	初
attitude	初
attractive	初
audience	初
#Australia	初
author	初
authority	初
automatic	初
available	初
average	初
avoid	初
award	初
aware	初
awful	初
#back#	初
background	初
bacon	初
bake	初
balance	初
ban	初
band	初
bank	初
bar	初
base	初
baseball	初
basket	初
battle	初
be	初
beat	初
#before	初
behave	初
#behind	初
believe	初
belong	初
below	初
belt	初
bend	初
beneath	初
benefit	初
besides	初
bet	初
beyond	初
bill	初
bit	初
bite	初
bitter	初
blame	初
blank	初
blind	初
block	初
blood	初
board	初
boil	初
bomb	初
#book	初
boot	初
border	初
bore/boring	初
boss	初
bother	初
bottom	初
brain	初
branch	初
breath	初
brick	初
bridge	初
brief	初
brilliant	初
bring	初
broad	初
broadcast	初
budget	初
build	初
burn	初
burst	初
business	初
button	初
#by	初
cabbage	初
cable	初
calculate	初
#call	初
calm	初
camp	初
campaign	初
#Canada	初
cancel	初
candidate	初
capable	初
capacity	初
capital	初
captain	初
capture	初
career	初
careful	初
carpet	初
carry	初
cartoon	初
case	初
cash	初
cast	初
castle	初
casual	初
cause	初
cave	初
CD	初
ceiling	初
celebrate	初
cell	初
cent	初
center/centre	初
century	初
ceremony	初
certain	初
chain	初
challenge	初
championship	初
chance	初
change	初
chapter	初
character	初
charge	初
charity	初
chart	初
chase	初
check	初
cheek	初
cheer	初
cheese	初
chemical	初
chemistry	初
check/cheque	初
chest	初
chief	初
choice	初
choose	初
church	初
cigaret(te)	初
#circle	初
circuit	初
circumstance	初
citizen	初
claim	初
classical	初
clear	初
client	初
climate	初
#close	初
club	初
coach	初
coal	初
coast	初
code	初
coin	初
#cold	初
collapse	初
colleague	初
collect	初
college	初
column	初
combine	初
comfortable	初
command	初
comment	初
commercial	初
commission	初
commit	初
committee	初
common	初
communicate	初
community	初
company	初
compare	初
competition	初
complain	初
complete	初
complex	初
complicated	初
component	初
composition	初
concentrate	初
concern	初
concert	初
conclusion	初
concrete	初
condition	初
conduct	初
conference	初
confident	初
confirm	初
conflict	初
confuse	初
congratulation	初
connect	初
conscious	初
consequence	初
consider	初
consist	初
constant	初
construct	初
consult	初
consumer	初
contact	初
contain	初
content	初
contest	初
continent	初
continue	初
contract	初
contrast	初
contribute	初
control	初
convenient	初
convention	初
conversation	初
convert	初
convince	初
#copy	初
corner	初
#correct	初
cosmetic(s)	初
cost	初
cottage	初
cotton	初
cough	初
council	初
counter	初
country	初
county	初
couple	初
courage	初
course	初
court	初
cover	初
crack	初
craft	初
crash	初
crazy	初
cream	初
create	初
creature	初
credit	初
crew	初
crime	初
crisis	初
criticize	初
crop	初
crowd	初
cruel	初
culture	初
cupboard	初
cure	初
curious	初
currency	初
current	初
curtain	初
cushion	初
customer	初
cycle	初
daily	初
damage	初
#dance	初
dare	初
data	初
deal	初
death	初
debate	初
debt	初
decade	初
decide	初
declare	初
decorate	初
defeat	初
defend	初
definite	初
degree	初
delay	初
deliberate	初
#delighted	初
deliver	初
demand	初
demonstration	初
deny	初
department	初
departure	初
depend	初
deposit	初
depth	初
describe	初
desert	初
deserve	初
design	初
desire	初
desperate	初
destroy	初
destruction	初
detail	初
detective	初
determined	初
develop	初
device	初
dictionary	初
die	初
diet	初
direction	初
disappoint	初
disaster	初
disk/disc	初
discipline	初
discover	初
discuss	初
disease	初
dismiss	初
display	初
distance	初
district	初
disturb	初
divide	初
document	初
dollar	初
domestic	初
dominate	初
double	初
doubt	初
downstairs	初
dozen	初
drag	初
drama	初
drawer	初
dream	初
dress	初
drop	初
drug	初
due	初
dull	初
during	初
dust	初
duty	初
DVD	初
each	初
eager	初
earn	初
earth	初
economy	初
edge	初
education	初
effect	初
efficient	初
effort	初
either	初
elderly	初
elect	初
electric	初
electronic	初
element	初
else	初
elsewhere	初
email/e-mail	初
emerge	初
emergency	初
emotion	初
emphasis	初
employ	初
enable	初
encourage	初
end	初
enemy	初
energy	初
engage	初
engine	初
enough	初
ensure	初
enter	初
enterprise	初
entertainment	初
enthusiasm	初
entire	初
entrance	初
entry	初
envelope	初
environment	初
equal	初
equipment	初
equivalent	初
error	初
escape	初
especially	初
essential	初
establish	初
estate	初
estimate	初
#Europe	初
even	初
event	初
eventually	初
ever	初
everybody/everyone	初
everyday	初
everything	初
everywhere	初
evidence	初
exact	初
examine	初
example	初
excellent	初
except	初
exchange	初
exciting	初
excuse	初
#exercise	初
exhibition	初
exist	初
expand	初
expect	初
expensive	初
experience	初
experiment	初
expert	初
explain	初
explore	初
export	初
express	初
extend	初
extent	初
extra	初
extraordinary	初
extreme	初
fact	初
factor	初
factory	初
fail	初
fair	初
faith	初
familiar	初
famous	初
fare	初
fascinate/fascinating	初
fashion	初
fasten	初
fault	初
favo(u)r	初
fear	初
feather	初
feature	初
fee	初
fellow	初
female	初
fence	初
festival	初
fetch	初
fever	初
few	初
field	初
fierce	初
fight	初
figure	初
file	初
fill	初
finally	初
financial	初
finish	初
#fire	初
firm	初
#first	初
fit	初
fix	初
flash	初
flat	初
flight	初
float	初
flood	初
flow	初
folk	初
fond	初
fool	初
force	初
forecast	初
foreign	初
forest	初
forget	初
forgive	初
form	初
fortune	初
forward	初
found	初
frame	初
freeze	初
frequent	初
fresh	初
frighten	初
fry	初
fuel	初
fun	初
function	初
fund	初
fundamental	初
furniture	初
future	初
gain	初
gallery	初
gap	初
garage	初
gas	初
gate	初
gather	初
gay	初
general	初
generation	初
generous	初
gentle	初
gesture	初
glance	初
global	初
goal	初
god	初
gold	初
golf	初
goods	初
government	初
gradually	初
graduate	初
grain	初
grand	初
grateful	初
greet	初
ground	初
grow	初
guarantee	初
guard	初
guest	初
guide	初
guilty	初
habit	初
handle	初
hang	初
happen	初
harbo(u)r	初
hardly	初
harm	初
hate	初
health	初
heat	初
heaven	初
height	初
hell	初
herself	初
hesitate	初
himself	初
hire	初
history	初
hit	初
hold	初
hole	初
holiday	初
honest	初
hono(u)r	初
hope	初
horrible	初
host	初
hotel	初
hour	初
household	初
however	初
huge	初
human	初
humo(u)r	初
hunt	初
hurt	初
husband	初
identify	初
if	初
ignore	初
ill	初
illegal	初
illustrate	初
image	初
imagine	初
immediately	初
impact	初
imply	初
import	初
important	初
impress	初
inch	初
incident	初
include	初
income	初
increase	初
indeed	初
independent	初
indicate	初
individual	初
indoor	初
industry	初
inevitable	初
infection	初
influence	初
informal	初
information	初
ingredient	初
initial	初
injure	初
inner	初
innocent	初
inquiry	初
inside	初
insist	初
instal(l)	初
instance	初
instead	初
institution	初
instruction	初
instrument	初
insurance	初
intelligence	初
intend	初
intense	初
interest	初
internal	初
international	初
interrupt	初
interview	初
into	初
introduce	初
invent	初
invest	初
investigate	初
invite	初
involve	初
iron	初
island	初
issue	初
item	初
itself	初
join	初
joint	初
joke	初
journalist	初
journey	初
joy	初
judge	初
junior	初
just	初
justice	初
keen	初
keep	初
key	初
kick	初
kid	初
kill	初
kind	初
king	初
kiss	初
knowledge	初
label	初
laboratory/lab	初
lack	初
land	初
language	初
last	初
later	初
launch	初
law	初
lawyer	初
lay	初
layer	初
lead	初
lean	初
leather	初
leave	初
lecture	初
legal	初
lend	初
length	初
level	初
license/-ence	初
lie	初
life	初
lift	初
likely	初
limit	初
line	初
link	初
lip	初
literature	初
load	初
loan	初
lock	初
lonely	初
#long	初
#look	初
loose	初
lorry	初
lose	初
loss	初
luck	初
machine	初
mad	初
magazine	初
mail	初
main	初
maintain	初
major	初
male	初
manage	初
manner	初
manufacture	初
mark	初
market	初
marry	初
mass	初
material	初
matter	初
maximum	初
maybe	初
meal	初
mean	初
means	初
measure	初
medicine	初
medium	初
member	初
memory	初
mental	初
mention	初
mess	初
message	初
metal	初
method	初
meter/metre	初
middle	初
midnight	初
mile	初
military	初
million	初
mind	初
minimum	初
minister	初
minor	初
minute	初
miss	初
mistake	初
mix	初
model	初
modern	初
modest	初
moment	初
monitor	初
mood	初
moral	初
morning	初
most	初
mostly	初
motion	初
motor	初
mountain	初
move	初
movie	初
#much	初
murder	初
muscle	初
museum	初
myself	初
mystery	初
nail	初
narrow	初
nation	初
native	初
nature	初
#near	初
nearby	初
nearly	初
neat	初
necessary	初
neck	初
negative	初
neighbo(u)r	初
neither	初
nervous	初
network	初
never	初
#next	初
nobody	初
none	初
nor	初
normal	初
note	初
nothing	初
notice	初
novel	初
nowhere	初
numerous	初
nut	初
obey	初
object	初
obligation	初
observe	初
obtain	初
obvious	初
occasion	初
occupation	初
occupy	初
occur	初
ocean	初
odd	初
off	初
offence	初
offer	初
official	初
oil	初
once	初
oneself	初
only	初
onto	初
opera	初
operate	初
opinion	初
opponent	初
opportunity	初
oppose	初
opposite	初
order	初
ordinary	初
organize	初
original	初
other	初
otherwise	初
ought (to)	初
ourselves	初
outcome	初
outdoor	初
outline	初
outside	初
outstanding	初
oven	初
overcome	初
owe	初
own	初
pace	初
#Pacific	初
pack	初
packet	初
pain	初
palace	初
pale	初
pan	初
paragraph	初
parent	初
parliament	初
part	初
particular	初
partner	初
pass	初
passage	初
passenger	初
passion	初
passport	初
path	初
patient	初
pattern	初
pause	初
pay	初
peace	初
peak	初
penalty	初
penny	初
per	初
percent	初
perfect	初
performance	初
perhaps	初
period	初
permanent	初
permit	初
person	初
persuade	初
petrol	初
phrase	初
physical	初
physics	初
piano	初
pie	初
pile	初
pilot	初
pin	初
pipe	初
pitch	初
#place	初
plain	初
plan	初
planet	初
plastic	初
platform	初
#play	初
pleasant	初
plenty	初
plot	初
pocket	初
poem	初
poet	初
#point	初
pole	初
police	初
policy	初
polite	初
politics	初
pollution	初
poor	初
popular	初
population	初
port	初
position	初
positive	初
possession	初
possible	初
#post	初
pot	初
pound	初
pour	初
power	初
practice	初
praise	初
precise	初
predict	初
prefer	初
pregnant	初
prepare	初
preserve	初
president	初
press	初
pretend	初
pretty	初
prevent	初
previous	初
price	初
pride	初
prince	初
principal	初
principle	初
print	初
priority	初
prison	初
private	初
prize	初
probably	初
problem	初
procedure	初
proceed	初
process	初
produce	初
product	初
profession	初
profit	初
program(me)	初
progress	初
project	初
promise	初
promote	初
pronounce	初
proof	初
proper	初
property	初
proportion	初
prospect	初
protect	初
protein	初
protest	初
proud	初
prove	初
provide	初
province	初
pub	初
public	初
publish	初
pump	初
punish	初
purchase	初
pure	初
purpose	初
qualify	初
quality	初
quantity	初
quarrel	初
queen	初
quite	初
race	初
railroad/railway	初
raise	初
range	初
rank	初
rapid	初
rare	初
rate	初
rather	初
raw	初
reach	初
react	初
real	初
realize	初
reason	初
receive	初
recently	初
recognize	初
recommend	初
record	初
recover	初
reduce	初
reference/ref	初
reflect	初
reform	初
refuse	初
regard	初
region	初
register	初
regret	初
regular	初
reject	初
relate	初
relative	初
relax	初
release	初
religious	初
rely	初
remain	初
remarkable	初
remember	初
remind	初
remote	初
remove	初
rent	初
repair	初
repeat	初
replace	初
reply	初
report	初
represent	初
republic	初
reputation	初
request	初
require	初
rescue	初
research	初
reserve	初
resign	初
resist	初
resource	初
respect	初
response	初
responsible	初
rest	初
restore	初
restrict	初
result	初
retire	初
return	初
reveal	初
review	初
revolution	初
reward	初
rich	初
#right	初
ring	初
rise	初
risk	初
rob	初
rock	初
role	初
roof	初
#round	初
route	初
routine	初
row	初
royal	初
rule	初
rural	初
rush	初
#safe	初
sail	初
sake	初
salary	初
sale	初
salt	初
sample	初
sand	初
satisfy	初
sauce	初
scheme	初
score	初
screen	初
search	初
seat	初
secret	初
secretary	初
section	初
secure	初
security	初
seek	初
seem	初
select	初
send	初
senior	初
separate	初
series	初
serious	初
servant	初
serve	初
set	初
settle	初
several	初
severe	初
sex	初
shade	初
shadow	初
shall	初
shame	初
shave	初
sheet	初
#ship	初
shock	初
shoot	初
#shop	初
shot	初
should	初
shower	初
side	初
sight	初
signal	初
significant	初
silent	初
silly	初
silver	初
similar	初
simple	初
since	初
single	初
sink	初
site	初
situation	初
skill	初
skin	初
#sleep	初
slice	初
slight	初
#smoke	初
social	初
society	初
software	初
soil	初
solve	初
somebody/someone	初
somehow	初
something	初
somewhere	初
soon	初
sort	初
soul	初
sound	初
source	初
space	初
spare	初
special	初
species	初
speech	初
speed	初
spend	初
spin	初
spirit	初
spite	初
split	初
spot	初
spread	初
stable	初
staff	初
stage	初
standard	初
stare	初
state	初
status	初
stay	初
steady	初
steal	初
steam	初
steel	初
step	初
stick	初
still	初
stir	初
stock	初
stomach	初
stone	初
store	初
straight	初
strange	初
stream	初
strength	初
stress	初
stretch	初
strict	初
strike	初
string	初
strip	初
structure	初
struggle	初
studio	初
stuff	初
stupid	初
style	初
substance	初
succeed	初
such	初
suddenly	初
suffer	初
sufficient	初
suggest	初
suitable	初
sum	初
super	初
supply	初
support	初
suppose	初
surface	初
surprise	初
surround	初
survive	初
suspect	初
sweat	初
switch	初
symbol	初
system	初
talent	初
tap	初
target	初
task	初
tax	初
teach	初
team	初
tear	初
technique	初
technology	初
temperature	初
tendency	初
term	初
test	初
text	初
than	初
themselves	初
theory	初
therefore	初
thorough	初
threat	初
through	初
throughout	初
thus	初
tie	初
tight	初
till/until	初
tiny	初
tip	初
title	初
tool	初
total	初
tough	初
tour	初
toward(s)	初
track	初
trade	初
tradition	初
#train	初
translate	初
transport	初
trap	初
travel	初
treat	初
trick	初
trip	初
trouble	初
trust	初
tube	初
twist	初
type	初
typical	初
union	初
unique	初
unite	初
universe	初
university	初
unless	初
#up	初
upon	初
upset	初
upstairs	初
urge	初
urgent	初
valley	初
value	初
variety	初
various	初
VCD	初
vehicle	初
victory	初
view	初
village	初
violence	初
#visit	初
vital	初
volume	初
voluntary	初
vote	初
wage	初
#walk	初
war	初
warn	初
waste	初
#wave	初
wealth	初
weapon	初
wedding	初
weekend	初
weigh	初
welfare	初
whatever	初
wheel	初
#when	初
whenever	初
#where	初
wherever	初
whether	初
#which	初
while	初
whisper	初
whole	初
whom	初
#whose	初
wide	初
wife	初
#will	初
wine	初
wing	初
wipe	初
wire	初
wise	初
#wish	初
within	初
without	初
witness	初
wonder	初
wood	初
wool	初
#work	初
worry	初
worth	初
wound	初
wrap	初
yard	初
yesterday	初
yet	初
yourself	初
youth	初
#zero	初
aboard	高
#above	高
absence	高
absent	高
absolute	高
absorb	高
abstract	高
academic	高
accommodation	高
accompany	高
#account	高
accountant	高
accuracy	高
accuse	高
ache	高
acid	高
acknowledge	高
acquire	高
#across	高
active	高
actor	高
actress	高
adapt	高
addition	高
address	高
adequate	高
adjective	高
adjust	高
admission	高
advance	高
advanced	高
adventure	高
adverb	高
advise	高
advocate	高
aeroplane	高
agency	高
agenda	高
aggressive	高
agriculture	高
AIDS	高
#air	高
air-conditioned	高
#air force	高
airmail	高
aeroplane/airplane	高
#alarm	高
album	高
alert	高
alike	高
alliance	高
allowance	高
aloud	高
alphabet	高
alter	高
altogether	高
alumnus	高
a.m.	高
amateur	高
ambitious	高
ambulance	高
#amount	高
amuse	高
#analyse	高
ancestor	高
anger	高
ankle	高
anniversary	高
annual	高
ant	高
anyhow	高
anymore	高
anyone	高
#anything	高
apart	高
ape	高
apology	高
apparent	高
#appeal	高
appearance	高
appetite	高
applause	高
applicant	高
#approach	高
approval	高
approximately	高
arcade	高
architecture	高
arise	高
arithmetic	高
#arm	高
arouse	高
arrival	高
artist	高
artistic	高
ash	高
aspirin	高
assemble	高
assess	高
assignment	高
assistance	高
assure	高
astronaut	高
athlete	高
ATM	高
atomic	高
#attack	高
#attempt	高
attention	高
attract	高
auction	高
auditorium	高
auto	高
#automatic	高
awake	高
#award	高
awkward	高
ax(e)	高
#back	高
backward(s)	高
bacteria	高
badminton	高
baggage	高
bakery	高
balcony	高
ballet	高
balloon	高
bamboo	高
#ban	高
banquet	高
#bar	高
barbecue BBQ	高
barber	高
bare	高
bargain	高
bark	高
barrel	高
basic	高
basin	高
#bath	高
bathe	高
battery	高
#battle	高
bay	高
#beach	高
bead	高
beast	高
#beat	高
beauty	高
bedroom	高
bee	高
beef	高
beforehand	高
beg	高
beginning	高
behalf	高
behavior	高
belief	高
#belt	高
bench	高
#bend	高
#beneath	高
berry	高
#bet	高
#beyond	高
bib	高
Bible	高
billion	高
bin	高
biology	高
birth	高
bishop	高
#bite	高
#bitter	高
blanket	高
bleed	高
bless	高
#blind	高
#block	高
blossom	高
blouse	高
#blow	高
#board	高
boast	高
bold	高
bonus	高
booklet	高
boom	高
#bore	高
#bottle	高
#bottom	高
bounce	高
bound	高
boundary	高
bow	高
bowel(s)	高
#box	高
boxing	高
brand	高
brass	高
breast	高
breathe	高
breed	高
breeze	高
bride	高
bridegroom	高
bridesmaid	高
bridesman	高
brigade	高
#broad	高
#broadcast	高
bubble	高
bucket	高
bug	高
building	高
bulb	高
bull	高
bullet	高
bump	高
bunch	高
burden	高
bureau	高
bury	高
bush	高
#but	高
butcher	高
cabin	高
cabinet	高
cafe	高
cage	高
calculator	高
calendar	高
#calm	高
camel	高
#campaign	高
#can	高
canal	高
cancer	高
candy	高
cane	高
canteen	高
#capture	高
care	高
cargo	高
carriage	高
carrot	高
cart	高
carve	高
#cash	高
cassette	高
#cast	高
casualty	高
catalog(ue)	高
category	高
cattle	高
caution	高
cease	高
centimeter/centimetre	高
central	高
CEO/Chief Executive Officer	高
certainty	高
certificate	高
#chain	高
chairman	高
chairperson	高
#chalk	高
#challenge	高
chamber	高
champion	高
#chance	高
characteristic	高
charm	高
#chart	高
#chase	高
chat	高
cheat	高
checklist	高
chemist	高
chess	高
childhood	高
chin	高
chopstick(s)	高
Christian	高
cigar	高
#circuit	高
circular	高
civil	高
civilization	高
claim	高
clap	高
#class	高
classic	高
classmate	高
classroom	高
clause	高
clay	高
clerk	高
click	高
clinic	高
clone	高
closet	高
cloth	高
clothing	高
#cloudy	高
clue	高
clumsy	高
#coach	高
cock	高
coke	高
#collapse	高
collar	高
#colo(u)r	高
comb	高
comedy	高
comfort	高
comic	高
#command	高
#comment	高
commerce	高
#common	高
companion	高
comparison	高
compass	高
compete	高
competitive	高
complaint	高
#component	高
compose	高
compound	高
comprehensive	高
compulsory	高
conceal	高
concept	高
conclude	高
#concrete	高
condemn	高
#conduct	高
confess	高
confidence	高
#conflict	高
congratulate	高
congress	高
construction	高
consultant	高
contemporary	高
contempt	高
context	高
continuous	高
#contract	高
contrary	高
#contrast	高
contribution	高
#convert	高
cookery	高
cooperate	高
cope	高
copper	高
cord	高
corporation	高
correspondent	高
corridor	高
cosmic	高
#cost	高
couch	高
#count	高
countryside	高
#couple	高
#course	高
#crack	高
#crash	高
crawl	高
creative	高
cricket	高
criminal	高
cripple	高
critical	高
#crowd	高
#crowded	高
crown	高
crucial	高
crystal	高
cultivate	高
#cup	高
#cure	高
curiosity	高
curl	高
#current	高
curriculum	高
#curtain	高
curve	高
#cushion	高
custom	高
#cut	高
cute	高
#cycle	高
#daily	高
dairy	高
#damage	高
damn	高
damp	高
danger	高
#dark	高
darling	高
dash	高
#date	高
dawn	高
dead	高
deaf	高
#deal	高
#dear	高
deceive	高
decision	高
deck	高
decline	高
decode	高
decrease	高
deed	高
#deep	高
deer	高
#defeat	高
define	高
deforestation	高
#deliberate	高
delicate	高
delicious	高
delight	高
delivery	高
#demand	高
democracy	高
dense	高
dentist	高
depart	高
dependent	高
#deposit	高
depress	高
#desert	高
desktop	高
despite	高
destination	高
#detail	高
#detective	高
determination	高
#determined	高
devote	高
diagram	高
dial	高
diamond	高
diary	高
dictation	高
difference	高
difficulty	高
digest	高
digitize	高
dignity	高
diligence	高
dim	高
dine	高
dip	高
diploma	高
direct	高
dirt	高
disadvantage	高
disappear	高
#disc	高
discard	高
#discipline	高
discount	高
#dish	高
disorder	高
dissolve	高
distant	高
distinguish	高
dive	高
division	高
divorce	高
dolphin	高
#domestic	高
#dominate	高
donkey	高
donor	高
dormitory	高
dot	高
#double	高
#downstairs	高
downtown	高
downward(s)	高
#doctor/Dr.	高
draft	高
#drag	高
dragon	高
dramatic	高
#draw	高
drawing	高
dread	高
drift	高
drill	高
#drive	高
drown	高
#drug	高
#drum	高
drunk	高
#due	高
#dull	高
dumpling	高
#dust	高
dustbin	高
dwelling	高
dye	高
earnest	高
earthquake	高
ease	高
eastern	高
economic	高
ecosystem	高
edition	高
educate	高
#effect	高
effective	高
efficiency	高
elder	高
electricity	高
elephant	高
elevator	高
embarrass	高
emphasize	高
empire	高
employee	高
#empty	高
enclose	高
encounter	高
endure	高
energetic	高
#engineer	高
engineering	高
enhance	高
enjoyable	高
enormous	高
#enough	高
entitle	高
envy	高
#equal	高
equip	高
#equivalent	高
era	高
erase	高
escalator	高
essay	高
etc.	高
#European	高
eve	高
#even	高
evil	高
evolution	高
examination	高
exception	高
excite	高
exclude	高
execute	高
#exercise	高
exhaust	高
exhilarate/exhilarating	高
existence	高
exit	高
expense	高
#expert	高
explanation	高
expose	高
exposure	高
#express	高
expression	高
external	高
#extra	高
#extreme	高
#eye	高
fable	高
facility	高
fade	高
failure	高
faint	高
#fair	高
fame	高
#fan	高
#far	高
#fare	高
farewell	高
#farm	高
farther	高
fashionable	高
fatal	高
fate	高
#favo(u)r	高
fax	高
feast	高
#feature	高
#fee	高
#feed	高
#feel	高
feeling	高
fertilizer	高
#fever	高
fiction	高
#file	高
#film	高
final	高
finance	高
#fine	高
firework	高
#firm	高
fisherman/fishermen	高
#fit	高
flame	高
#flat	高
flavo(u)r	高
fleet	高
flexible	高
#flood	高
flour	高
#flow	高
flu	高
fluent	高
focus	高
fog	高
#fold	高
#folk	高
following	高
foolish	高
#for	高
forbid	高
forehead	高
forever	高
fork	高
formal	高
formation	高
former	高
formula	高
forth	高
fortunate	高
forty	高
foster	高
foundation	高
fraction	高
fragile	高
#frame	高
framework	高
frank	高
#free	高
freedom	高
#fresh	高
friendly	高
frog	高
#fry	高
#fuel	高
fulfil(l)	高
#full	高
#fund	高
#fundamental	高
#funny	高
fur	高
further	高
furthermore	高
#gain	高
gamble	高
gang	高
gangster	高
#gap	高
#garage	高
garbage	高
#garden	高
#gay	高
gaze	高
gender	高
gene	高
#general	高
genius	高
genuine	高
geography	高
germ	高
#German	高
ghost	高
giant	高
#glance	高
glide	高
glorious	高
glove	高
#glue	高
#goal	高
goat	高
#gold	高
golden	高
#golf	高
#goods	高
goose	高
govern	高
grab	高
grace	高
#grade	高
grammar	高
grandchild	高
grandson	高
grant	高
grasp	高
gratitude	高
grave	高
gravity	高
greedy	高
#group	高
#guarantee	高
#guide	高
gulf	高
#gun	高
gymnasium/gym	高
hack	高
hairdryer	高
hamburger	高
hammer	高
handbag	高
handkerchief	高
#handle	高
handsome	高
hardship	高
harmful	高
harmony	高
harsh	高
harvest	高
haste	高
hatch	高
hatred	高
hawk	高
#head	高
headache	高
headline	高
headmaster	高
headphone	高
headquarters	高
heal	高
healthy	高
hearing	高
helicopter	高
#hell	高
helmet	高
hen	高
hero	高
high-tech	高
highway	高
hint	高
#hire	高
historian	高
historical	高
#hit	高
#hold	高
hollow	高
holography	高
holy	高
homeland	高
homesick	高
honeymoon	高
#hono(u)r	高
hook	高
horizon	高
horn	高
horror	高
#host	高
hostage	高
hostess	高
#house	高
housewife	高
housework	高
hunger	高
hurricane	高
hut	高
hydrogen	高
iceberg	高
ideal	高
idiom	高
#ill	高
#image	高
imaginary	高
imitate	高
immigrate	高
implement	高
impose	高
impression	高
#include/including	高
index	高
#individual	高
induce	高
industrial	高
infect	高
inferior	高
inform	高
infrared	高
inherit	高
initiative	高
injection	高
injury	高
#ink	高
inn	高
input	高
inquire	高
insert	高
inspect	高
inspire	高
instant	高
institute	高
insult	高
intellectual	高
intelligent	高
intensive	高
intention	高
internet	高
interpret	高
interval	高
intervention	高
introduction	高
invade	高
invention	高
investigation	高
investment	高
invisible	高
invitation	高
involvement	高
#iron	高
isolate	高
#item	高
#jam	高
#Japanese	高
jar	高
jaw	高
jazz	高
jealous	高
jeans	高
jeep	高
#jelly	高
jet	高
jewelry	高
journal	高
#journey	高
judgment	高
junction	高
#junior	高
#just	高
justify	高
karaoke	高
kettle	高
#key	高
keyboard	高
#kid	高
kidnap	高
kindergarten	高
kingdom	高
kneel	高
knit	高
knot	高
#label	高
labo(u)r	高
lad	高
ladder	高
landscape	高
lane	高
lap	高
laser	高
#last	高
lately	高
latter	高
lawn	高
lazy	高
leadership	高
leading	高
league	高
leak	高
leap	高
learning	高
lease	高
#leave	高
legislation	高
leisure	高
lemon	高
lemonade	高
lens	高
#level	高
liberty	高
#license/-ence	高
lid	高
#lie	高
lifetime	高
lightning	高
#limit	高
limited	高
lion	高
liquid	高
#list	高
literary	高
liter/litre	高
litter	高
#live	高
lively	高
living	高
#load	高
loaf	高
log	高
logic	高
lord	高
lovely	高
loyalty	高
lucky	高
luggage	高
lump	高
luxury	高
machinery	高
madam	高
magic	高
magician	高
magnate	高
magnet	高
magnificent	高
magnify	高
maid	高
maiden	高
mailbox	高
#main	高
#major	高
majority	高
management	高
mania	高
mankind	高
manual	高
#manufacture	高
manuscript	高
marathon	高
marble	高
march	高
margin	高
marine	高
marital	高
marriage	高
marrow	高
marsh	高
marvelous	高
mask	高
master	高
mastermind	高
mat	高
mate	高
mature	高
mayor	高
meadow	高
#mean	高
meaning	高
meanwhile	高
#measure	高
measurement	高
mechanical	高
mechanism	高
medal	高
medical	高
melon	高
melt	高
membership	高
memorize	高
mend	高
menu	高
merchant	高
mercy	高
mere	高
merit	高
merry	高
#mess	高
metropolis	高
microscope	高
microwave	高
#mouse/mice	高
mid	高
might	高
mighty	高
migrate	高
mild	高
milestone	高
#milk	高
mill	高
mini	高
ministry	高
#minor	高
minority	高
#minus	高
miracle	高
miscellanea	高
mischief	高
miserable	高
missing	高
mission	高
mist	高
#mistake	高
mixture	高
moan	高
mob	高
mobile	高
#model	高
moderate	高
modify	高
moist	高
mold	高
#monitor	高
monk	高
monkey	高
monopoly	高
monotone	高
monster	高
monthly	高
monument	高
mop	高
moped	高
more	高
moreover	高
mortgage	高
moss	高
#motion	高
motorbike	高
mount	高
mourn	高
movement	高
mow	高
mud	高
multiple	高
murmur	高
mushroom	高
musical	高
musician	高
mute	高
mutton	高
mutual	高
mysterious	高
myth	高
#nail	高
naked	高
nap	高
napkin	高
nasty	高
national	高
nationality	高
#native	高
natural	高
naughty	高
navy	高
necklace	高
needle	高
neglect	高
negotiate	高
negotiation	高
Negro	高
neighbo(u)rhood	高
nephew	高
nerve	高
nest	高
neutral	高
nevertheless	高
newsreel	高
niece	高
noble	高
noisy	高
nominal	高
nominate	高
nonsense	高
nonstop	高
noodle	高
noon	高
northern	高
notify	高
notion	高
noun	高
nourish	高
nowadays	高
nuclear	高
numeral	高
#nurse	高
nursery	高
nylon	高
oak	高
oath	高
obedience	高
obedient	高
#object	高
objective	高
obscure	高
#occasion	高
odds	高
offend	高
offish	高
#oil	高
oilcan	高
okay/O.K./OK	高
olive	高
#Olympic	高
omit	高
onion	高
#opponent	高
oppress	高
optic	高
optimize	高
option	高
oral	高
orbit	高
organ	高
orient	高
origin	高
#original	高
orphan	高
ounce	高
outbid	高
outer	高
outlet	高
#outline	高
outlook	高
overall	高
overboard	高
overcast	高
overcoat	高
overdo	高
overlook	高
overnight	高
overpass	高
overseas	高
overtake	高
overthrow	高
owl	高
ownership	高
ox	高
oxygen	高
p.m./post meridiem	高
#pace	高
#pack	高
package	高
pad	高
paddle	高
painting	高
pajamas/pyjamas	高
palm	高
pamphlet	高
panic	高
pant	高
parade	高
parallel	高
parcel	高
pardon	高
parrot	高
#part	高
participate	高
participle	高
#pass	高
password	高
paste	高
pat	高
patent	高
#patient	高
patrol	高
#pattern	高
pavement	高
#peach	高
peacock	高
#peak	高
#pear	高
pearl	高
peculiar	高
pedal	高
peel	高
peep	高
peer	高
#pen	高
#pencil	高
pension	高
pepper	高
percentage	高
#perfect	高
perform	高
perfume	高
permission	高
persevere	高
persist	高
personnel	高
pest	高
phenomenon	高
philosopher	高
pianist	高
#pick	高
#picture	高
pigeon	高
#pile	高
pill	高
pillar	高
pillow	高
#pilot	高
pine	高
#pineapple	高
#pink	高
#pipe	高
pity	高
#pizza	高
#plain	高
#plastic	高
#plate	高
playground	高
#plot	高
plug	高
plunge	高
plural	高
poetry	高
poison	高
polish	高
pond	高
pony	高
#pool	高
pork	高
#port	高
porter	高
portion	高
portrait	高
possess	高
possibility	高
postcard	高
#pot	高
#pound	高
poverty	高
powder	高
#power	高
pray	高
precaution	高
#precise	高
preface	高
prejudice	高
premium	高
preparation	高
preposition	高
pressure	高
#pretty	高
prey	高
priest	高
prime	高
princess	高
probable	高
#process	高
#produce	高
professor	高
#progress	高
prohibit	高
#project	高
prominent	高
prompt	高
pronunciation	高
#proportion	高
proposal	高
propose	高
prosperous	高
proverb	高
provision	高
psychology	高
pudding	高
puff	高
#pull	高
pulse	高
#pump	高
puncture	高
#purchase	高
purse	高
puzzle	高
pyramid	高
#quarrel	高
queer	高
queue	高
quilt	高
quit	高
quotation	高
quote	高
#rabbit	高
#race/racing	高
radar	高
rag	高
rail	高
rainbow	高
raincoat	高
raindrop	高
#rainy	高
#raise	高
#range	高
#rank	高
#rapid	高
rat	高
#rate	高
#raw	高
ray	高
#reach	高
reap	高
#reason	高
reasonable	高
rebel	高
recall	高
receipt	高
recent	高
reception	高
recite	高
#rectangle	高
recycle	高
refer	高
#reform	高
refrigerator	高
refusal	高
#regard	高
regarding	高
#register	高
#regret	高
#reject	高
rejoice	高
relation	高
#relative	高
#release	高
reliable	高
relief	高
relieve	高
reluctant	高
remark	高
remedy	高
removal	高
renew	高
#rent	高
representative	高
#rescue	高
#research	高
resemble	高
reservoir	高
residence	高
resolution	高
resolve	高
resort	高
resound	高
#respect	高
respectfully	高
respectively	高
respond	高
responsibility	高
retain	高
retreat	高
#return	高
reunion	高
reverse	高
revise	高
revision	高
#reward	高
rhyme	高
rid	高
#riddle	高
ridiculous	高
ripe	高
#rise	高
ritual	高
roar	高
roast	高
robbery	高
#robot	高
#rock	高
rocket	高
rod	高
#role	高
roll	高
#Roman	高
romantic	高
#roof	高
root	高
rot	高
rouge	高
#round	高
#routine	高
#row	高
rub	高
rude	高
rugby	高
ruin	高
#ruler	高
#rush	高
#Russian	高
rust	高
sack	高
sacrifice	高
safety	高
#salad	高
#sample	高
#sandwich	高
satellite	高
satire	高
satisfactory	高
#sauce	高
saw	高
scale	高
scarcely	高
#scarf	高
scatter	高
scenery	高
scent	高
schedule	高
#scheme	高
scholar	高
#school	高
scold	高
#score	高
scrub	高
seafood	高
seal	高
#season	高
#seat	高
secondary	高
#secret	高
#secure	高
#seed	高
seize	高
seldom	高
self	高
selfish	高
#senior	高
#sense	高
sensible	高
#sentence	高
#separate	高
service	高
#set	高
sew	高
#shade	高
#shadow	高
#shake	高
shallow	高
#shame	高
shampoo	高
#share	高
#sharp	高
#shave	高
shed	高
#shell	高
shelter	高
shift	高
#shock	高
#shoot	高
shopkeeper	高
#shop/shopping	高
shore	高
#shoulder	高
#show	高
#shower	高
shy	高
#side	高
#sight	高
sightseeing	高
#sign	高
#signal	高
signature	高
silk	高
#silly	高
#silver	高
sincere	高
#single	高
#sink	高
#site	高
skate	高
ski	高
skim	高
#skin	高
skip	高
skirt	高
slave	高
sleeve	高
#slice	高
#slight	高
slim	高
slip	高
slogan	高
slope	高
#slow	高
smash	高
smog	高
#smooth	高
snack	高
snail	高
snap	高
snatch	高
sneeze	高
#soap	高
sob	高
soccer	高
sofa	高
#soil	高
solar	高
solid	高
solution	高
somewhat	高
sophisticated	高
sore	高
sorrow	高
#sort	高
#sound	高
sour	高
souvenir	高
#space	高
spade	高
#spare	高
spark	高
sparrow	高
spear	高
specialist	高
specific	高
spectacle	高
spectator	高
spill	高
#spin	高
spit	高
splash	高
#split	高
spoil	高
sponsor	高
#spoon	高
#sport	高
#spot	高
spray	高
#spread	高
#spring	高
spy	高
squeeze	高
stadium	高
#staff	高
#stage	高
stair	高
stall	高
#stand	高
#standard	高
#star	高
#stare	高
#start	高
starve	高
#state	高
#station	高
stationery	高
#steady	高
steak	高
#steam	高
#steel	高
steep	高
steer	高
stereo	高
#still	高
stimulate	高
#stir	高
#stock	高
stocking(s)	高
#stone	高
story/storey	高
#storm	高
strain	高
strand	高
straw	高
#strawberry	高
#stretch	高
#strike	高
#string	高
#strip	高
strive	高
stroke	高
#structure	高
#style	高
submit	高
subscribe	高
substitute	高
suburb	高
subway	高
success	高
suck	高
suit	高
#sum	高
summarize	高
summary	高
summit	高
summon	高
#sun	高
sunrise	高
sunshine	高
superior	高
supplementary	高
#surface	高
#suspect	高
suspend	高
suspicion	高
swallow	高
swan	高
swear	高
#sweat	高
#sweep	高
swell	高
sword	高
sympathy	高
symptom	高
tablet	高
tag	高
#tail	高
tailor	高
tale	高
tame	高
tank	高
#tap	高
#tape	高
#target	高
#tax	高
#taxi	高
#team	高
technical	高
teenager	高
telescope	高
temper	高
temperate	高
temple	高
temporary	高
tempt	高
tend	高
tender	高
tense	高
tent	高
terminal	高
terrific	高
territory	高
terror	高
theme	高
thief	高
thirsty	高
thought	高
thread	高
throat	高
thunder	高
tick	高
#ticket	高
tide	高
tidy	高
#tight	高
#time	高
timetable	高
timid	高
tin	高
#tip	高
tiptoe	高
tire	高
tiresome	高
tissue	高
toast	高
toe	高
#toilet	高
tolerate	高
tomb	高
ton	高
tone	高
toothache	高
toothpaste	高
topic	高
tortoise	高
toss	高
#total	高
#touch	高
#tour	高
tourist	高
tournament	高
#towel	高
#tower	高
#toy	高
trace	高
#track	高
tragedy	高
tram	高
transfer	高
transform	高
transmit	高
transplant	高
#trap	高
tray	高
treasure	高
#treat	高
treaty	高
tremble	高
tremendous	高
trend	高
trial	高
#triangle	高
tribe	高
#trick	高
#trip	高
triumph	高
trolley	高
troop	高
troublesome	高
#truck	高
trunk	高
#trust	高
truth	高
tune	高
tunnel	高
turtle	高
tutor	高
twin	高
twinkle	高
#type	高
typhoon	高
typist	高
tyre	高
UFO	高
#ugly	高
umbrella	高
undergo	高
#underground	高
underline	高
underpass	高
undo	高
unearth	高
universal	高
unusual	高
upper	高
up-to-date	高
upward(s)	高
urban	高
usage	高
used	高
useful	高
user	高
vacant	高
vacation	高
vacuum	高
#value	高
vapo(u)r	高
vary	高
vase	高
vast	高
VCR	高
vegetarian	高
venture	高
venue	高
verb	高
version	高
vest	高
vice	高
victim	高
#view	高
viewpoint	高
vigo(u)r	高
virtue	高
virus	高
visible	高
vision	高
vitamin	高
vivid	高
vocabulary	高
vocation	高
#voice	高
volunteer	高
#vote	高
voyage	高
wag	高
wagon	高
waist	高
waken	高
Walkman	高
#wall	高
wallet	高
wander	高
ward	高
ware	高
#warm	高
#wash	高
#waste	高
waterfall	高
waterproof	高
wax	高
#wear	高
weave	高
web	高
weed	高
weep	高
weight	高
#well	高
well-known	高
western	高
#wet	高
whale	高
wheat	高
whip	高
whirlpool	高
whisky	高
#whisper	高
whistle	高
whitewash	高
whoever	高
#whole	高
wholesale	高
#wide	高
widow	高
width	高
willing	高
willow	高
wisdom	高
wit	高
withdraw	高
wolf	高
worldwide	高
worm	高
worthless	高
worthy	高
wreck	高
wrist	高
#wrong	高
x-ray	高
yawn	高
#yes/yeah	高
yogurt	高
youngster	高
#youth	高
#zebra	高
zigzag	高
zip	高
zone	高
#zoo	高
zookeeper	高
zoology	高
zoom	高
